aboli=[aboi],
abolie=[aboie],
abolies=[aboies],
abolis=[abois],
absolus=[absous],
accentuel=[accentue],
accentuelle=[accentuee],
accentuelles=[accentuees],
accentuels=[accentues],
accidentel=[accidente],
accidentelle=[accidentee],
accidentelles=[accidentees],
accidentels=[accidentes],
additionnel=[additionne],
additionnelle=[additionnee],
additionnelles=[additionnees],
additionnels=[additionnes],
adjectival=[adjectiva],
ail=[ai],
aile=[aie],
ailes=[aies],
aille=[aie],
aillent=[aient],
ailles=[aies],
ails=[ais],
aldols=[ados],
alerions=[aerions],
aliment=[aiment],
alise=[aise],
alises=[aises],
allerent=[aerent],
allie=[aie],
allient=[aient],
allies=[aies],
alune=[aune],
alunes=[aunes],
alvine=[avine],
alvines=[avines],
amblons=[ambons],
anal=[ana],
angle=[ange],
angles=[anges],
animal=[anima],
annele=[annee],
anneles=[annees],
annelle=[annee],
annelles=[annees],
annulaire=[annuaire],
annulaires=[annuaires],
apostillez=[apostiez],
apostillons=[apostions],
arable=[arabe],
arables=[arabes],
arbitral=[arbitra],
architectural=[architectura],
armorial=[armoria],
ascensionnel=[ascensionne],
ascensionnelle=[ascensionnee],
ascensionnelles=[ascensionnees],
ascensionnels=[ascensionnes],
asexuel=[asexue],
asexuelle=[asexuee],
asexuelles=[asexuees],
asexuels=[asexues],
assoupli=[assoupi],
assouplie=[assoupie],
assouplies=[assoupies],
assouplimes=[assoupimes],
assouplir=[assoupir],
assouplira=[assoupira],
assouplirai=[assoupirai],
assoupliraient=[assoupiraient],
assouplirais=[assoupirais],
assouplirait=[assoupirait],
assoupliras=[assoupiras],
assouplirent=[assoupirent],
assouplirez=[assoupirez],
assoupliriez=[assoupiriez],
assouplirions=[assoupirions],
assouplirons=[assoupirons],
assoupliront=[assoupiront],
assouplis=[assoupis],
assouplissaient=[assoupissaient],
assouplissais=[assoupissais],
assouplissait=[assoupissait],
assouplissant=[assoupissant],
assouplisse=[assoupisse],
assouplissement=[assoupissement],
assouplissements=[assoupissements],
assouplissent=[assoupissent],
assouplisses=[assoupisses],
assouplissez=[assoupissez],
assouplissiez=[assoupissiez],
assouplissions=[assoupissions],
assouplissons=[assoupissons],
assouplit=[assoupit],
assouplites=[assoupites],
attirail=[attirai],
attirails=[attirais],
augural=[augura],
aulne=[aune],
aulnes=[aunes],
baffle=[baffe],
baffles=[baffes],
bafouillez=[bafouiez],
bafouillons=[bafouions],
bail=[bai],
baille=[baie],
baillent=[baient],
baillera=[baiera],
baillerai=[baierai],
bailleraient=[baieraient],
baillerais=[baierais],
baillerait=[baierait],
bailleras=[baieras],
baillerez=[baierez],
bailleriez=[baieriez],
baillerions=[baierions],
baillerons=[baierons],
bailleront=[baieront],
bailles=[baies],
balcon=[bacon],
balisa=[baisa],
balisai=[baisai],
balisaient=[baisaient],
balisais=[baisais],
balisait=[baisait],
balisames=[baisames],
balisant=[baisant],
balisas=[baisas],
balisasse=[baisasse],
balisassent=[baisassent],
balisasses=[baisasses],
balisassiez=[baisassiez],
balisassions=[baisassions],
balisat=[baisat],
balisates=[baisates],
balise=[baise],
balisee=[baisee],
balisees=[baisees],
balisent=[baisent],
baliser=[baiser],
balisera=[baisera],
baliserai=[baiserai],
baliseraient=[baiseraient],
baliserais=[baiserais],
baliserait=[baiserait],
baliseras=[baiseras],
baliserent=[baiserent],
baliserez=[baiserez],
baliseriez=[baiseriez],
baliserions=[baiserions],
baliserons=[baiserons],
baliseront=[baiseront],
balises=[baises],
baliseur=[baiseur],
baliseurs=[baiseurs],
balisez=[baisez],
balisiez=[baisiez],
balisions=[baisions],
balisons=[baisons],
bals=[bas],
balsa=[basa],
balte=[bate],
baltes=[bates],
barbele=[barbee],
barbeles=[barbees],
barbillons=[barbions],
barbule=[barbue],
barbules=[barbues],
basal=[basa],
basaltes=[basates],
baselle=[basee],
baselles=[basees],
bastillonna=[bastionna],
bastillonnai=[bastionnai],
bastillonnaient=[bastionnaient],
bastillonnais=[bastionnais],
bastillonnait=[bastionnait],
bastillonnames=[bastionnames],
bastillonnant=[bastionnant],
bastillonnas=[bastionnas],
bastillonnasse=[bastionnasse],
bastillonnassent=[bastionnassent],
bastillonnasses=[bastionnasses],
bastillonnassiez=[bastionnassiez],
bastillonnassions=[bastionnassions],
bastillonnat=[bastionnat],
bastillonnates=[bastionnates],
bastillonne=[bastionne],
bastillonnee=[bastionnee],
bastillonnees=[bastionnees],
bastillonnent=[bastionnent],
bastillonner=[bastionner],
bastillonnera=[bastionnera],
bastillonnerai=[bastionnerai],
bastillonneraient=[bastionneraient],
bastillonnerais=[bastionnerais],
bastillonnerait=[bastionnerait],
bastillonneras=[bastionneras],
bastillonnerent=[bastionnerent],
bastillonnerez=[bastionnerez],
bastillonneriez=[bastionneriez],
bastillonnerions=[bastionnerions],
bastillonnerons=[bastionnerons],
bastillonneront=[bastionneront],
bastillonnes=[bastionnes],
bastillonnez=[bastionnez],
bastillonniez=[bastionniez],
bastillonnions=[bastionnions],
bastillonnons=[bastionnons],
bataillent=[bataient],
batele=[batee],
bateles=[batees],
batelle=[batee],
batelles=[batees],
bechamels=[bechames],
bela=[bea],
belai=[beai],
belaient=[beaient],
belais=[beais],
belait=[beait],
belames=[beames],
belant=[beant],
belante=[beante],
belantes=[beantes],
belants=[beants],
belas=[beas],
belasse=[beasse],
belassent=[beassent],
belasses=[beasses],
belassiez=[beassiez],
belassions=[beassions],
belat=[beat],
belates=[beates],
bele=[bee],
belent=[beent],
beler=[beer],
belera=[beera],
belerai=[beerai],
beleraient=[beeraient],
belerais=[beerais],
belerait=[beerait],
beleras=[beeras],
belerent=[beerent],
belerez=[beerez],
beleriez=[beeriez],
belerions=[beerions],
belerons=[beerons],
beleront=[beeront],
beles=[bees],
belez=[beez],
beliez=[beiez],
belions=[beions],
belle=[bee],
belles=[bees],
belons=[beons],
bequillez=[bequiez],
bequillons=[bequions],
bercail=[bercai],
betel=[bete],
betels=[betes],
biglames=[bigames],
bilais=[biais],
bills=[bis],
bisexuel=[bisexue],
bisexuelle=[bisexuee],
bisexuelles=[bisexuees],
bisexuels=[bisexues],
bissexuel=[bissexue],
bissexuelle=[bissexuee],
bissexuelles=[bissexuees],
bissexuels=[bissexues],
blabla=[baba],
blablas=[babas],
blagua=[bagua],
blaguai=[baguai],
blaguaient=[baguaient],
blaguais=[baguais],
blaguait=[baguait],
blaguames=[baguames],
blaguant=[baguant],
blaguas=[baguas],
blaguasse=[baguasse],
blaguassent=[baguassent],
blaguasses=[baguasses],
blaguassiez=[baguassiez],
blaguassions=[baguassions],
blaguat=[baguat],
blaguates=[baguates],
blague=[bague],
blaguee=[baguee],
blaguees=[baguees],
blaguent=[baguent],
blaguer=[baguer],
blaguera=[baguera],
blaguerai=[baguerai],
blagueraient=[bagueraient],
blaguerais=[baguerais],
blaguerait=[baguerait],
blagueras=[bagueras],
blaguerent=[baguerent],
blaguerez=[baguerez],
blagueriez=[bagueriez],
blaguerions=[baguerions],
blaguerons=[baguerons],
blagueront=[bagueront],
blagues=[bagues],
blaguez=[baguez],
blaguiez=[baguiez],
blaguions=[baguions],
blaguons=[baguons],
blanc=[banc],
blanche=[banche],
blanches=[banches],
blancs=[bancs],
blanquette=[banquette],
blanquettes=[banquettes],
blasa=[basa],
blasai=[basai],
blasaient=[basaient],
blasais=[basais],
blasait=[basait],
blasames=[basames],
blasant=[basant],
blasas=[basas],
blasasse=[basasse],
blasassent=[basassent],
blasasses=[basasses],
blasassiez=[basassiez],
blasassions=[basassions],
blasat=[basat],
blasates=[basates],
blase=[base],
blasee=[basee],
blasees=[basees],
blasent=[basent],
blaser=[baser],
blasera=[basera],
blaserai=[baserai],
blaseraient=[baseraient],
blaserais=[baserais],
blaserait=[baserait],
blaseras=[baseras],
blaserent=[baserent],
blaserez=[baserez],
blaseriez=[baseriez],
blaserions=[baserions],
blaserons=[baserons],
blaseront=[baseront],
blases=[bases],
blasez=[basez],
blasiez=[basiez],
blasions=[basions],
blasons=[basons],
blatera=[batera],
blaterai=[baterai],
blateraient=[bateraient],
blaterais=[baterais],
blaterait=[baterait],
blateras=[bateras],
blaterent=[baterent],
blaterez=[baterez],
blateriez=[bateriez],
blaterions=[baterions],
blaterons=[baterons],
blatte=[batte],
blattes=[battes],
bleche=[beche],
bleches=[beches],
blesant=[besant],
blette=[bette],
blettes=[bettes],
blocage=[bocage],
blocages=[bocages],
blond=[bond],
blondasse=[bondasse],
blondasses=[bondasses],
blonde=[bonde],
blondel=[bonde],
blondels=[bondes],
blondes=[bondes],
blondi=[bondi],
blondimes=[bondimes],
blondir=[bondir],
blondirent=[bondirent],
blondis=[bondis],
blondissaient=[bondissaient],
blondissais=[bondissais],
blondissait=[bondissait],
blondissant=[bondissant],
blondisse=[bondisse],
blondissent=[bondissent],
blondisses=[bondisses],
blondissez=[bondissez],
blondissiez=[bondissiez],
blondissions=[bondissions],
blondissons=[bondissons],
blondit=[bondit],
blondites=[bondites],
blonds=[bonds],
blouse=[bouse],
blouses=[bouses],
blues=[bues],
bluta=[buta],
blutai=[butai],
blutaient=[butaient],
blutais=[butais],
blutait=[butait],
blutames=[butames],
blutant=[butant],
blutas=[butas],
blutasse=[butasse],
blutassent=[butassent],
blutasses=[butasses],
blutassiez=[butassiez],
blutassions=[butassions],
blutat=[butat],
blutates=[butates],
blute=[bute],
blutee=[butee],
blutees=[butees],
blutent=[butent],
bluter=[buter],
blutera=[butera],
bluterai=[buterai],
bluteraient=[buteraient],
bluterais=[buterais],
bluterait=[buterait],
bluteras=[buteras],
bluterent=[buterent],
bluterez=[buterez],
bluteriez=[buteriez],
bluterions=[buterions],
bluterons=[buterons],
bluteront=[buteront],
blutes=[butes],
blutez=[butez],
blutiez=[butiez],
blutions=[butions],
blutoir=[butoir],
blutoirs=[butoirs],
blutons=[butons],
boitiller=[boitier],
boitillez=[boitiez],
boitillons=[boitions],
bondelle=[bondee],
bondelles=[bondees],
bordel=[borde],
bordels=[bordes],
bossele=[bossee],
bosseles=[bossees],
bosselle=[bossee],
bosselles=[bossees],
bottele=[bottee],
botteles=[bottees],
bottelle=[bottee],
bottelles=[bottees],
bottillons=[bottions],
boule=[boue],
boulee=[bouee],
boulees=[bouees],
boules=[boues],
bourrele=[bourree],
bourreles=[bourrees],
bourrelle=[bourree],
bourrelles=[bourrees],
bousiller=[bousier],
bradel=[brade],
braille=[braie],
braillent=[braient],
braillera=[braiera],
braillerai=[braierai],
brailleraient=[braieraient],
braillerais=[braierais],
braillerait=[braierait],
brailleras=[braieras],
braillerez=[braierez],
brailleriez=[braieriez],
braillerions=[braierions],
braillerons=[braierons],
brailleront=[braieront],
brailles=[braies],
brandille=[brandie],
brandilles=[brandies],
brasiller=[brasier],
brasillez=[brasiez],
brasillons=[brasions],
brettele=[brettee],
bretteles=[brettees],
brettelle=[brettee],
brettelles=[brettees],
brille=[brie],
brilles=[bries],
brulant=[bruant],
brulants=[bruants],
brulis=[bruis],
bulle=[bue],
bulles=[bues],
cablas=[cabas],
cablot=[cabot],
cablots=[cabots],
cadastral=[cadastra],
cal=[ca],
calcique=[cacique],
calciques=[caciques],
calisson=[caisson],
calissons=[caissons],
calme=[came],
calmee=[camee],
calmees=[camees],
calmera=[camera],
calmeras=[cameras],
calmes=[cames],
calmions=[camions],
calqua=[caqua],
calquai=[caquai],
calquaient=[caquaient],
calquais=[caquais],
calquait=[caquait],
calquames=[caquames],
calquant=[caquant],
calquas=[caquas],
calquasse=[caquasse],
calquassent=[caquassent],
calquasses=[caquasses],
calquassiez=[caquassiez],
calquassions=[caquassions],
calquat=[caquat],
calquates=[caquates],
calque=[caque],
calquee=[caquee],
calquees=[caquees],
calquent=[caquent],
calquer=[caquer],
calquera=[caquera],
calquerai=[caquerai],
calqueraient=[caqueraient],
calquerais=[caquerais],
calquerait=[caquerait],
calqueras=[caqueras],
calquerent=[caquerent],
calquerez=[caquerez],
calqueriez=[caqueriez],
calquerions=[caquerions],
calquerons=[caquerons],
calqueront=[caqueront],
calques=[caques],
calquez=[caquez],
calquiez=[caquiez],
calquions=[caquions],
calquons=[caquons],
cals=[cas],
caltions=[cations],
calva=[cava],
calvas=[cavas],
camelle=[camee],
camelles=[camees],
canal=[cana],
cannele=[cannee],
canneles=[cannees],
cannelle=[cannee],
cannelles=[cannees],
capela=[capea],
capelai=[capeai],
capelaient=[capeaient],
capelais=[capeais],
capelait=[capeait],
capelames=[capeames],
capelant=[capeant],
capelas=[capeas],
capelasse=[capeasse],
capelassent=[capeassent],
capelasses=[capeasses],
capelassiez=[capeassiez],
capelassions=[capeassions],
capelat=[capeat],
capelates=[capeates],
capele=[capee],
capeler=[capeer],
capelerent=[capeerent],
capeles=[capees],
capelez=[capeez],
capeliez=[capeiez],
capelions=[capeions],
capelle=[capee],
capellent=[capeent],
capellera=[capeera],
capellerai=[capeerai],
capelleraient=[capeeraient],
capellerais=[capeerais],
capellerait=[capeerait],
capelleras=[capeeras],
capellerez=[capeerez],
capelleriez=[capeeriez],
capellerions=[capeerions],
capellerons=[capeerons],
capelleront=[capeeront],
capelles=[capees],
capelons=[capeons],
captal=[capta],
captals=[captas],
cardial=[cardia],
caricatural=[caricatura],
carillons=[carions],
carliste=[cariste],
carlistes=[caristes],
carnele=[carnee],
carneles=[carnees],
carrele=[carree],
carreles=[carrees],
carrelle=[carree],
carrelles=[carrees],
cartel=[carte],
cartels=[cartes],
castel=[caste],
castels=[castes],
categoriel=[categorie],
categoriels=[categories],
causal=[causa],
causals=[causas],
cendrillons=[cendrions],
central=[centra],
cercle=[cerce],
cercles=[cerces],
ceremoniel=[ceremonie],
ceremoniels=[ceremonies],
chalut=[chaut],
chancel=[chance],
chancels=[chances],
chapele=[chapee],
chapeles=[chapees],
chapelle=[chapee],
chapelles=[chapees],
chevelu=[cheveu],
chloree=[choree],
chlorees=[chorees],
chlorions=[chorions],
cil=[ci],
circonstanciel=[circonstancie],
circonstancielle=[circonstanciee],
circonstancielles=[circonstanciees],
circonstanciels=[circonstancies],
citronnelle=[citronnee],
citronnelles=[citronnees],
clabot=[cabot],
clabota=[cabota],
clabotage=[cabotage],
clabotages=[cabotages],
clabotai=[cabotai],
clabotaient=[cabotaient],
clabotais=[cabotais],
clabotait=[cabotait],
clabotames=[cabotames],
clabotant=[cabotant],
clabotas=[cabotas],
clabotasse=[cabotasse],
clabotassent=[cabotassent],
clabotasses=[cabotasses],
clabotassiez=[cabotassiez],
clabotassions=[cabotassions],
clabotat=[cabotat],
clabotates=[cabotates],
clabote=[cabote],
clabotent=[cabotent],
claboter=[caboter],
clabotera=[cabotera],
claboterai=[caboterai],
claboteraient=[caboteraient],
claboterais=[caboterais],
claboterait=[caboterait],
claboteras=[caboteras],
claboterent=[caboterent],
claboterez=[caboterez],
claboteriez=[caboteriez],
claboterions=[caboterions],
claboterons=[caboterons],
claboteront=[caboteront],
clabotes=[cabotes],
clabotez=[cabotez],
clabotiez=[cabotiez],
clabotions=[cabotions],
clabotons=[cabotons],
clabots=[cabots],
clade=[cade],
clades=[cades],
clame=[came],
clamee=[camee],
clamees=[camees],
clamera=[camera],
clameras=[cameras],
clames=[cames],
clamions=[camions],
clamp=[camp],
clampa=[campa],
clampai=[campai],
clampaient=[campaient],
clampais=[campais],
clampait=[campait],
clampames=[campames],
clampant=[campant],
clampas=[campas],
clampasse=[campasse],
clampassent=[campassent],
clampasses=[campasses],
clampassiez=[campassiez],
clampassions=[campassions],
clampat=[campat],
clampates=[campates],
clampe=[campe],
clampee=[campee],
clampees=[campees],
clampent=[campent],
clamper=[camper],
clampera=[campera],
clamperai=[camperai],
clamperaient=[camperaient],
clamperais=[camperais],
clamperait=[camperait],
clamperas=[camperas],
clamperent=[camperent],
clamperez=[camperez],
clamperiez=[camperiez],
clamperions=[camperions],
clamperons=[camperons],
clamperont=[camperont],
clampes=[campes],
clampez=[campez],
clampiez=[campiez],
clampions=[campions],
clampons=[campons],
clamps=[camps],
clape=[cape],
clapes=[capes],
clapites=[capites],
clapons=[capons],
clapota=[capota],
clapotage=[capotage],
clapotages=[capotages],
clapotai=[capotai],
clapotaient=[capotaient],
clapotais=[capotais],
clapotait=[capotait],
clapotames=[capotames],
clapotant=[capotant],
clapotas=[capotas],
clapotasse=[capotasse],
clapotassent=[capotassent],
clapotasses=[capotasses],
clapotassiez=[capotassiez],
clapotassions=[capotassions],
clapotat=[capotat],
clapotates=[capotates],
clapote=[capote],
clapotent=[capotent],
clapoter=[capoter],
clapotera=[capotera],
clapoterai=[capoterai],
clapoteraient=[capoteraient],
clapoterais=[capoterais],
clapoterait=[capoterait],
clapoteras=[capoteras],
clapoterent=[capoterent],
clapoterez=[capoterez],
clapoteriez=[capoteriez],
clapoterions=[capoterions],
clapoterons=[capoterons],
clapoteront=[capoteront],
clapotes=[capotes],
clapotez=[capotez],
clapotiez=[capotiez],
clapotions=[capotions],
clapotons=[capotons],
clappa=[cappa],
clappas=[cappas],
claqua=[caqua],
claquai=[caquai],
claquaient=[caquaient],
claquais=[caquais],
claquait=[caquait],
claquames=[caquames],
claquant=[caquant],
claquas=[caquas],
claquasse=[caquasse],
claquassent=[caquassent],
claquasses=[caquasses],
claquassiez=[caquassiez],
claquassions=[caquassions],
claquat=[caquat],
claquates=[caquates],
claque=[caque],
claquee=[caquee],
claquees=[caquees],
claquent=[caquent],
claquer=[caquer],
claquera=[caquera],
claquerai=[caquerai],
claqueraient=[caqueraient],
claquerais=[caquerais],
claquerait=[caquerait],
claqueras=[caqueras],
claquerent=[caquerent],
claquerez=[caquerez],
claqueriez=[caqueriez],
claquerions=[caquerions],
claquerons=[caquerons],
claqueront=[caqueront],
claques=[caques],
claquet=[caquet],
claqueta=[caqueta],
claquetai=[caquetai],
claquetaient=[caquetaient],
claquetais=[caquetais],
claquetait=[caquetait],
claquetames=[caquetames],
claquetant=[caquetant],
claquetas=[caquetas],
claquetasse=[caquetasse],
claquetassent=[caquetassent],
claquetasses=[caquetasses],
claquetassiez=[caquetassiez],
claquetassions=[caquetassions],
claquetat=[caquetat],
claquetates=[caquetates],
claquete=[caquete],
claqueter=[caqueter],
claqueterent=[caqueterent],
claquetez=[caquetez],
claquetiez=[caquetiez],
claquetions=[caquetions],
claquetons=[caquetons],
claquets=[caquets],
claquette=[caquette],
claquettent=[caquettent],
claquettera=[caquettera],
claquetterai=[caquetterai],
claquetteraient=[caquetteraient],
claquetterais=[caquetterais],
claquetterait=[caquetterait],
claquetteras=[caquetteras],
claquetterez=[caquetterez],
claquetteriez=[caquetteriez],
claquetterions=[caquetterions],
claquetterons=[caquetterons],
claquetteront=[caquetteront],
claquettes=[caquettes],
claquez=[caquez],
claquiez=[caquiez],
claquions=[caquions],
claquons=[caquons],
clarte=[carte],
clartes=[cartes],
classa=[cassa],
classai=[cassai],
classaient=[cassaient],
classais=[cassais],
classait=[cassait],
classames=[cassames],
classant=[cassant],
classas=[cassas],
classasse=[cassasse],
classassent=[cassassent],
classasses=[cassasses],
classassiez=[cassassiez],
classassions=[cassassions],
classat=[cassat],
classates=[cassates],
classe=[casse],
classee=[cassee],
classees=[cassees],
classement=[cassement],
classements=[cassements],
classent=[cassent],
classer=[casser],
classera=[cassera],
classerai=[casserai],
classeraient=[casseraient],
classerais=[casserais],
classerait=[casserait],
classeras=[casseras],
classerent=[casserent],
classerez=[casserez],
classeriez=[casseriez],
classerions=[casserions],
classerons=[casserons],
classeront=[casseront],
classes=[casses],
classeur=[casseur],
classeurs=[casseurs],
classez=[cassez],
classiez=[cassiez],
classions=[cassions],
classons=[cassons],
clause=[cause],
clauses=[causes],
clava=[cava],
clavai=[cavai],
clavaient=[cavaient],
clavais=[cavais],
clavait=[cavait],
clavames=[cavames],
clavant=[cavant],
clavas=[cavas],
clavasse=[cavasse],
clavassent=[cavassent],
clavasses=[cavasses],
clavassiez=[cavassiez],
clavassions=[cavassions],
clavat=[cavat],
clavates=[cavates],
clave=[cave],
claveau=[caveau],
clavee=[cavee],
clavees=[cavees],
clavele=[cavee],
claveles=[cavees],
clavent=[cavent],
claver=[caver],
clavera=[cavera],
claverai=[caverai],
claveraient=[caveraient],
claverais=[caverais],
claverait=[caverait],
claveras=[caveras],
claverent=[caverent],
claverez=[caverez],
claveriez=[caveriez],
claverions=[caverions],
claverons=[caverons],
claveront=[caveront],
claves=[caves],
clavez=[cavez],
claviez=[caviez],
clavions=[cavions],
claviste=[caviste],
clavistes=[cavistes],
clavons=[cavons],
cle=[ce],
clement=[cement],
clemente=[cemente],
clementes=[cementes],
clements=[cements],
cles=[ces],
clinquante=[cinquante],
clocha=[cocha],
clochai=[cochai],
clochaient=[cochaient],
clochais=[cochais],
clochait=[cochait],
clochames=[cochames],
clochant=[cochant],
clochas=[cochas],
clochasse=[cochasse],
clochassent=[cochassent],
clochasses=[cochasses],
clochassiez=[cochassiez],
clochassions=[cochassions],
clochat=[cochat],
clochates=[cochates],
cloche=[coche],
clochee=[cochee],
clochees=[cochees],
clochent=[cochent],
clocher=[cocher],
clochera=[cochera],
clocherai=[cocherai],
clocheraient=[cocheraient],
clocherais=[cocherais],
clocherait=[cocherait],
clocheras=[cocheras],
clocherent=[cocherent],
clocherez=[cocherez],
clocheriez=[cocheriez],
clocherions=[cocherions],
clocherons=[cocherons],
clocheront=[cocheront],
clochers=[cochers],
cloches=[coches],
clochez=[cochez],
clochiez=[cochiez],
clochions=[cochions],
clochons=[cochons],
clone=[cone],
clones=[cones],
clopina=[copina],
clopinai=[copinai],
clopinaient=[copinaient],
clopinais=[copinais],
clopinait=[copinait],
clopinames=[copinames],
clopinant=[copinant],
clopinas=[copinas],
clopinasse=[copinasse],
clopinassent=[copinassent],
clopinasses=[copinasses],
clopinassiez=[copinassiez],
clopinassions=[copinassions],
clopinat=[copinat],
clopinates=[copinates],
clopine=[copine],
clopinent=[copinent],
clopiner=[copiner],
clopinera=[copinera],
clopinerai=[copinerai],
clopineraient=[copineraient],
clopinerais=[copinerais],
clopinerait=[copinerait],
clopineras=[copineras],
clopinerent=[copinerent],
clopinerez=[copinerez],
clopineriez=[copineriez],
clopinerions=[copinerions],
clopinerons=[copinerons],
clopineront=[copineront],
clopines=[copines],
clopinez=[copinez],
clopiniez=[copiniez],
clopinions=[copinions],
clopinons=[copinons],
cloqua=[coqua],
cloquai=[coquai],
cloquaient=[coquaient],
cloquais=[coquais],
cloquait=[coquait],
cloquames=[coquames],
cloquant=[coquant],
cloquas=[coquas],
cloquasse=[coquasse],
cloquassent=[coquassent],
cloquasses=[coquasses],
cloquassiez=[coquassiez],
cloquassions=[coquassions],
cloquat=[coquat],
cloquates=[coquates],
cloque=[coque],
cloquent=[coquent],
cloquer=[coquer],
cloquera=[coquera],
cloquerai=[coquerai],
cloqueraient=[coqueraient],
cloquerais=[coquerais],
cloquerait=[coquerait],
cloqueras=[coqueras],
cloquerent=[coquerent],
cloquerez=[coquerez],
cloqueriez=[coqueriez],
cloquerions=[coquerions],
cloquerons=[coquerons],
cloqueront=[coqueront],
cloques=[coques],
cloquez=[coquez],
cloquiez=[coquiez],
cloquions=[coquions],
cloquons=[coquons],
clorons=[corons],
clou=[cou],
clous=[cous],
clouta=[couta],
cloutai=[coutai],
cloutaient=[coutaient],
cloutais=[coutais],
cloutait=[coutait],
cloutames=[coutames],
cloutant=[coutant],
cloutas=[coutas],
cloutasse=[coutasse],
cloutassent=[coutassent],
cloutasses=[coutasses],
cloutassiez=[coutassiez],
cloutassions=[coutassions],
cloutat=[coutat],
cloutates=[coutates],
cloute=[coute],
cloutee=[coutee],
cloutees=[coutees],
cloutent=[coutent],
clouter=[couter],
cloutera=[coutera],
clouterai=[couterai],
clouteraient=[couteraient],
clouterais=[couterais],
clouterait=[couterait],
clouteras=[couteras],
clouterent=[couterent],
clouterez=[couterez],
clouteriez=[couteriez],
clouterions=[couterions],
clouterons=[couterons],
clouteront=[couteront],
cloutes=[coutes],
cloutez=[coutez],
cloutiez=[coutiez],
cloutions=[coutions],
cloutons=[coutons],
clubiste=[cubiste],
clubistes=[cubistes],
colin=[coin],
colins=[coins],
colis=[cois],
colite=[coite],
colites=[coites],
collasse=[coasse],
collassent=[coassent],
collasses=[coasses],
collassiez=[coassiez],
collassions=[coassions],
colleur=[coeur],
colleurs=[coeurs],
collusions=[cousions],
colluvions=[couvions],
comblat=[combat],
comble=[combe],
combles=[combes],
completa=[competa],
completai=[competai],
completaient=[competaient],
completais=[competais],
completait=[competait],
completames=[competames],
completant=[competant],
completas=[competas],
completasse=[competasse],
completassent=[competassent],
completasses=[competasses],
completassiez=[competassiez],
completassions=[competassions],
completat=[competat],
completates=[competates],
complete=[compete],
completent=[competent],
completer=[competer],
completera=[competera],
completerai=[competerai],
completeraient=[competeraient],
completerais=[competerais],
completerait=[competerait],
completeras=[competeras],
completerent=[competerent],
completerez=[competerez],
completeriez=[competeriez],
completerions=[competerions],
completerons=[competerons],
completeront=[competeront],
completes=[competes],
completez=[competez],
completiez=[competiez],
completions=[competions],
completons=[competons],
complote=[compote],
complotes=[compotes],
complut=[comput],
complutes=[computes],
conclave=[concave],
conclaves=[concaves],
conclu=[concu],
conclue=[concue],
conclues=[concues],
conclumes=[concumes],
conclurent=[concurent],
conclus=[concus],
conclusse=[concusse],
conclussent=[concussent],
conclusses=[concusses],
conclussiez=[concussiez],
conclussions=[concussions],
conclut=[concut],
conclutes=[concutes],
conditionnel=[conditionne],
conditionnelle=[conditionnee],
conditionnelles=[conditionnees],
conditionnels=[conditionnes],
confederal=[confedera],
conflit=[confit],
conflits=[confits],
conjectural=[conjectura],
conjoncturel=[conjoncture],
conjoncturels=[conjonctures],
continuel=[continue],
continuelle=[continuee],
continuelles=[continuees],
continuels=[continues],
conventionnel=[conventionne],
conventionnelle=[conventionnee],
conventionnelles=[conventionnees],
conventionnels=[conventionnes],
coquillez=[coquiez],
coquillons=[coquions],
cordele=[cordee],
cordeles=[cordees],
cordelle=[cordee],
cordelles=[cordees],
cotele=[cotee],
coteles=[cotees],
cotillons=[cotions],
couchaillent=[couchaient],
coupaillent=[coupaient],
coupelle=[coupee],
coupelles=[coupees],
coupla=[coupa],
couplage=[coupage],
couplages=[coupages],
couplai=[coupai],
couplaient=[coupaient],
couplais=[coupais],
couplait=[coupait],
couplames=[coupames],
couplant=[coupant],
couplas=[coupas],
couplasse=[coupasse],
couplassent=[coupassent],
couplasses=[coupasses],
couplassiez=[coupassiez],
couplassions=[coupassions],
couplat=[coupat],
couplates=[coupates],
couple=[coupe],
couplee=[coupee],
couplees=[coupees],
couplent=[coupent],
coupler=[couper],
couplera=[coupera],
couplerai=[couperai],
coupleraient=[couperaient],
couplerais=[couperais],
couplerait=[couperait],
coupleras=[couperas],
couplerent=[couperent],
couplerez=[couperez],
coupleriez=[couperiez],
couplerions=[couperions],
couplerons=[couperons],
coupleront=[couperont],
couples=[coupes],
couplez=[coupez],
coupliez=[coupiez],
couplions=[coupions],
couplons=[coupons],
couraillent=[couraient],
craille=[craie],
crailles=[craies],
craquele=[craquee],
craqueles=[craquees],
craquelle=[craquee],
craquelles=[craquees],
crenele=[crenee],
creneles=[crenees],
crenelle=[crenee],
crenelles=[crenees],
criaillent=[criaient],
croisillons=[croisions],
cruel=[crue],
cruels=[crues],
cuvele=[cuvee],
cuveles=[cuvees],
cuvelle=[cuvee],
cuvelles=[cuvees],
dalmates=[damates],
daltons=[datons],
deblatera=[debatera],
deblaterai=[debaterai],
deblateraient=[debateraient],
deblaterais=[debaterais],
deblaterait=[debaterait],
deblateras=[debateras],
deblaterent=[debaterent],
deblaterez=[debaterez],
deblateriez=[debateriez],
deblaterions=[debaterions],
deblaterons=[debaterons],
debraille=[debraie],
debraillent=[debraient],
debraillera=[debraiera],
debraillerai=[debraierai],
debrailleraient=[debraieraient],
debraillerais=[debraierais],
debraillerait=[debraierait],
debrailleras=[debraieras],
debraillerez=[debraierez],
debrailleriez=[debraieriez],
debraillerions=[debraierions],
debraillerons=[debraierons],
debrailleront=[debraieront],
debrailles=[debraies],
decapele=[decapee],
decapeles=[decapees],
decapelle=[decapee],
decapelles=[decapees],
decimal=[decima],
declora=[decora],
declorai=[decorai],
decloraient=[decoraient],
declorais=[decorais],
declorait=[decorait],
decloras=[decoras],
declore=[decore],
declorez=[decorez],
decloriez=[decoriez],
declorions=[decorions],
declorons=[decorons],
decoupla=[decoupa],
decouplage=[decoupage],
decouplages=[decoupages],
decouplai=[decoupai],
decouplaient=[decoupaient],
decouplais=[decoupais],
decouplait=[decoupait],
decouplames=[decoupames],
decouplant=[decoupant],
decouplas=[decoupas],
decouplasse=[decoupasse],
decouplassent=[decoupassent],
decouplasses=[decoupasses],
decouplassiez=[decoupassiez],
decouplassions=[decoupassions],
decouplat=[decoupat],
decouplates=[decoupates],
decouple=[decoupe],
decouplee=[decoupee],
decouplees=[decoupees],
decouplent=[decoupent],
decoupler=[decouper],
decouplera=[decoupera],
decouplerai=[decouperai],
decoupleraient=[decouperaient],
decouplerais=[decouperais],
decouplerait=[decouperait],
decoupleras=[decouperas],
decouplerent=[decouperent],
decouplerez=[decouperez],
decoupleriez=[decouperiez],
decouplerions=[decouperions],
decouplerons=[decouperons],
decoupleront=[decouperont],
decouples=[decoupes],
decouplez=[decoupez],
decoupliez=[decoupiez],
decouplions=[decoupions],
decouplons=[decoupons],
deferla=[defera],
deferlai=[deferai],
deferlaient=[deferaient],
deferlais=[deferais],
deferlait=[deferait],
deferlames=[deferames],
deferlant=[deferant],
deferlas=[deferas],
deferlasse=[deferasse],
deferlassent=[deferassent],
deferlasses=[deferasses],
deferlassiez=[deferassiez],
deferlassions=[deferassions],
deferlat=[deferat],
deferlates=[deferates],
deferle=[defere],
deferlee=[deferee],
deferlees=[deferees],
deferlent=[deferent],
deferler=[deferer],
deferlera=[deferera],
deferlerai=[defererai],
deferleraient=[defereraient],
deferlerais=[defererais],
deferlerait=[defererait],
deferleras=[defereras],
deferlerent=[defererent],
deferlerez=[defererez],
deferleriez=[defereriez],
deferlerions=[defererions],
deferlerons=[defererons],
deferleront=[defereront],
deferles=[deferes],
deferlez=[deferez],
deferliez=[deferiez],
deferlions=[deferions],
deferlons=[deferons],
defila=[defia],
defilai=[defiai],
defilaient=[defiaient],
defilais=[defiais],
defilait=[defiait],
defilames=[defiames],
defilant=[defiant],
defilas=[defias],
defilasse=[defiasse],
defilassent=[defiassent],
defilasses=[defiasses],
defilassiez=[defiassiez],
defilassions=[defiassions],
defilat=[defiat],
defilates=[defiates],
defile=[defie],
defilee=[defiee],
defilees=[defiees],
defilent=[defient],
defiler=[defier],
defilera=[defiera],
defilerai=[defierai],
defileraient=[defieraient],
defilerais=[defierais],
defilerait=[defierait],
defileras=[defieras],
defilerent=[defierent],
defilerez=[defierez],
defileriez=[defieriez],
defilerions=[defierions],
defilerons=[defierons],
defileront=[defieront],
defiles=[defies],
defilez=[defiez],
defiliez=[defiiez],
defilions=[defiions],
defilons=[defions],
delite=[deite],
delites=[deites],
deluterons=[deuterons],
demelure=[demeure],
demelures=[demeures],
dementiel=[dementie],
dementiels=[dementies],
dentele=[dentee],
denteles=[dentees],
dentelle=[dentee],
dentelles=[dentees],
deparla=[depara],
deparlai=[deparai],
deparlaient=[deparaient],
deparlais=[deparais],
deparlait=[deparait],
deparlames=[deparames],
deparlant=[deparant],
deparlas=[deparas],
deparlasse=[deparasse],
deparlassent=[deparassent],
deparlasses=[deparasses],
deparlassiez=[deparassiez],
deparlassions=[deparassions],
deparlat=[deparat],
deparlates=[deparates],
deparle=[depare],
deparlent=[deparent],
deparler=[deparer],
deparlera=[deparera],
deparlerai=[deparerai],
deparleraient=[depareraient],
deparlerais=[deparerais],
deparlerait=[deparerait],
deparleras=[depareras],
deparlerent=[deparerent],
deparlerez=[deparerez],
deparleriez=[depareriez],
deparlerions=[deparerions],
deparlerons=[deparerons],
deparleront=[depareront],
deparles=[depares],
deparlez=[deparez],
deparliez=[depariez],
deparlions=[deparions],
deparlons=[deparons],
deplurent=[depurent],
deplutes=[deputes],
deraille=[deraie],
deraillent=[deraient],
deraillera=[deraiera],
deraillerai=[deraierai],
derailleraient=[deraieraient],
deraillerais=[deraierais],
deraillerait=[deraierait],
derailleras=[deraieras],
deraillerez=[deraierez],
derailleriez=[deraieriez],
deraillerions=[deraierions],
deraillerons=[deraierons],
derailleront=[deraieront],
derailles=[deraies],
devoile=[devoie],
devoilement=[devoiement],
devoilements=[devoiements],
devoilent=[devoient],
devoilera=[devoiera],
devoilerai=[devoierai],
devoileras=[devoieras],
devoiles=[devoies],
devolte=[devote],
devoltes=[devotes],
devoltions=[devotions],
devolue=[devoue],
devolues=[devoues],
diesel=[diese],
diesels=[dieses],
dimensionnel=[dimensionne],
dimensionnelle=[dimensionnee],
dimensionnelles=[dimensionnees],
dimensionnels=[dimensionnes],
discutaillent=[discutaient],
dispersal=[dispersa],
dispersals=[dispersas],
disputaillent=[disputaient],
dissolus=[dissous],
dol=[do],
dols=[dos],
dotal=[dota],
douelle=[douee],
douelles=[douees],
draille=[draie],
drailles=[draies],
duel=[due],
duels=[dues],
durillon=[durion],
durillons=[durions],
eboula=[eboua],
eboulai=[ebouai],
eboulaient=[ebouaient],
eboulais=[ebouais],
eboulait=[ebouait],
eboulames=[ebouames],
eboulant=[ebouant],
eboulas=[ebouas],
eboulasse=[ebouasse],
eboulassent=[ebouassent],
eboulasses=[ebouasses],
eboulassiez=[ebouassiez],
eboulassions=[ebouassions],
eboulat=[ebouat],
eboulates=[ebouates],
eboule=[eboue],
eboulee=[ebouee],
eboulees=[ebouees],
eboulent=[ebouent],
ebouler=[ebouer],
eboulera=[ebouera],
eboulerai=[ebouerai],
ebouleraient=[eboueraient],
eboulerais=[ebouerais],
eboulerait=[ebouerait],
ebouleras=[eboueras],
eboulerent=[ebouerent],
eboulerez=[ebouerez],
ebouleriez=[eboueriez],
eboulerions=[ebouerions],
eboulerons=[ebouerons],
ebouleront=[eboueront],
eboules=[eboues],
eboulez=[ebouez],
ebouliez=[ebouiez],
eboulions=[ebouions],
eboulons=[ebouons],
ecartele=[ecartee],
ecarteles=[ecartees],
eclopa=[ecopa],
eclopai=[ecopai],
eclopaient=[ecopaient],
eclopais=[ecopais],
eclopait=[ecopait],
eclopames=[ecopames],
eclopant=[ecopant],
eclopas=[ecopas],
eclopasse=[ecopasse],
eclopassent=[ecopassent],
eclopasses=[ecopasses],
eclopassiez=[ecopassiez],
eclopassions=[ecopassions],
eclopat=[ecopat],
eclopates=[ecopates],
eclope=[ecope],
eclopee=[ecopee],
eclopees=[ecopees],
eclopent=[ecopent],
ecloper=[ecoper],
eclopera=[ecopera],
ecloperai=[ecoperai],
ecloperaient=[ecoperaient],
ecloperais=[ecoperais],
ecloperait=[ecoperait],
ecloperas=[ecoperas],
ecloperent=[ecoperent],
ecloperez=[ecoperez],
ecloperiez=[ecoperiez],
ecloperions=[ecoperions],
ecloperons=[ecoperons],
ecloperont=[ecoperont],
eclopes=[ecopes],
eclopez=[ecopez],
eclopiez=[ecopiez],
eclopions=[ecopions],
eclopons=[ecopons],
eclora=[ecora],
eclorai=[ecorai],
ecloraient=[ecoraient],
eclorais=[ecorais],
eclorait=[ecorait],
ecloras=[ecoras],
eclore=[ecore],
eclorez=[ecorez],
ecloriez=[ecoriez],
eclorions=[ecorions],
eclorons=[ecorons],
eclot=[ecot],
ecrivaillent=[ecrivaient],
ecrouelles=[ecrouees],
ecroulames=[ecrouames],
ecroulassiez=[ecrouassiez],
ecroulassions=[ecrouassions],
ecroulates=[ecrouates],
ecroule=[ecroue],
ecroulee=[ecrouee],
ecroulees=[ecrouees],
ecrouler=[ecrouer],
ecroulerez=[ecrouerez],
ecrouleriez=[ecroueriez],
ecroulerions=[ecrouerions],
ecroulerons=[ecrouerons],
ecroules=[ecroues],
ecroulez=[ecrouez],
ecrouliez=[ecrouiez],
ecroulions=[ecrouions],
ecroulons=[ecrouons],
egaille=[egaie],
egaillerez=[egaierez],
egailleriez=[egaieriez],
egaillerions=[egaierions],
egaillerons=[egaierons],
egailles=[egaies],
elider=[eider],
elu=[eu],
elue=[eue],
elues=[eues],
elumes=[eumes],
elurent=[eurent],
elus=[eus],
elusse=[eusse],
elussent=[eussent],
elusses=[eusses],
elussiez=[eussiez],
elussions=[eussions],
elut=[eut],
elutes=[eutes],
emotionnel=[emotionne],
emotionnelle=[emotionnee],
emotionnelles=[emotionnees],
emotionnels=[emotionnes],
emplira=[empira],
emplirai=[empirai],
empliraient=[empiraient],
emplirais=[empirais],
emplirait=[empirait],
empliras=[empiras],
emplirent=[empirent],
emplirez=[empirez],
empliriez=[empiriez],
emplirions=[empirions],
emplirons=[empirons],
emplois=[empois],
emule=[emue],
emules=[emues],
enclava=[encava],
enclavai=[encavai],
enclavaient=[encavaient],
enclavais=[encavais],
enclavait=[encavait],
enclavames=[encavames],
enclavant=[encavant],
enclavas=[encavas],
enclavasse=[encavasse],
enclavassent=[encavassent],
enclavasses=[encavasses],
enclavassiez=[encavassiez],
enclavassions=[encavassions],
enclavat=[encavat],
enclavates=[encavates],
enclave=[encave],
enclavee=[encavee],
enclavees=[encavees],
enclavement=[encavement],
enclavements=[encavements],
enclavent=[encavent],
enclaver=[encaver],
enclavera=[encavera],
enclaverai=[encaverai],
enclaveraient=[encaveraient],
enclaverais=[encaverais],
enclaverait=[encaverait],
enclaveras=[encaveras],
enclaverent=[encaverent],
enclaverez=[encaverez],
enclaveriez=[encaveriez],
enclaverions=[encaverions],
enclaverons=[encaverons],
enclaveront=[encaveront],
enclaves=[encaves],
enclavez=[encavez],
enclaviez=[encaviez],
enclavions=[encavions],
enclavons=[encavons],
enclore=[encore],
encolure=[encoure],
encolures=[encoures],
enflant=[enfant],
enfler=[enfer],
enfutaillent=[enfutaient],
engloba=[engoba],
englobai=[engobai],
englobaient=[engobaient],
englobais=[engobais],
englobait=[engobait],
englobames=[engobames],
englobant=[engobant],
englobas=[engobas],
englobasse=[engobasse],
englobassent=[engobassent],
englobasses=[engobasses],
englobassiez=[engobassiez],
englobassions=[engobassions],
englobat=[engobat],
englobates=[engobates],
englobe=[engobe],
englobee=[engobee],
englobees=[engobees],
englobent=[engobent],
englober=[engober],
englobera=[engobera],
engloberai=[engoberai],
engloberaient=[engoberaient],
engloberais=[engoberais],
engloberait=[engoberait],
engloberas=[engoberas],
engloberent=[engoberent],
engloberez=[engoberez],
engloberiez=[engoberiez],
engloberions=[engoberions],
engloberons=[engoberons],
engloberont=[engoberont],
englobes=[engobes],
englobez=[engobez],
englobiez=[engobiez],
englobions=[engobions],
englobons=[engobons],
engoulames=[engouames],
engoulassiez=[engouassiez],
engoulassions=[engouassions],
engoulates=[engouates],
engoule=[engoue],
engoulee=[engouee],
engoulees=[engouees],
engouler=[engouer],
engoulerez=[engouerez],
engouleriez=[engoueriez],
engoulerions=[engouerions],
engoulerons=[engouerons],
engoules=[engoues],
engoulez=[engouez],
engouliez=[engouiez],
engoulions=[engouions],
engoulons=[engouons],
enraille=[enraie],
enraillent=[enraient],
enraillera=[enraiera],
enraillerai=[enraierai],
enrailleraient=[enraieraient],
enraillerais=[enraierais],
enraillerait=[enraierait],
enrailleras=[enraieras],
enraillerez=[enraierez],
enrailleriez=[enraieriez],
enraillerions=[enraierions],
enraillerons=[enraierons],
enrailleront=[enraieront],
enrailles=[enraies],
enrouillez=[enrouiez],
enrouillons=[enrouions],
enroula=[enroua],
enroulai=[enrouai],
enroulaient=[enrouaient],
enroulais=[enrouais],
enroulait=[enrouait],
enroulames=[enrouames],
enroulant=[enrouant],
enroulas=[enrouas],
enroulasse=[enrouasse],
enroulassent=[enrouassent],
enroulasses=[enrouasses],
enroulassiez=[enrouassiez],
enroulassions=[enrouassions],
enroulat=[enrouat],
enroulates=[enrouates],
enroule=[enroue],
enroulee=[enrouee],
enroulees=[enrouees],
enroulement=[enrouement],
enroulements=[enrouements],
enroulent=[enrouent],
enrouler=[enrouer],
enroulera=[enrouera],
enroulerai=[enrouerai],
enrouleraient=[enroueraient],
enroulerais=[enrouerais],
enroulerait=[enrouerait],
enrouleras=[enroueras],
enroulerent=[enrouerent],
enroulerez=[enrouerez],
enrouleriez=[enroueriez],
enroulerions=[enrouerions],
enroulerons=[enrouerons],
enrouleront=[enroueront],
enroules=[enroues],
enroulez=[enrouez],
enrouliez=[enrouiez],
enroulions=[enrouions],
enroulons=[enrouons],
entaillent=[entaient],
envoile=[envoie],
envoiles=[envoies],
epannele=[epannee],
epanneles=[epannees],
epannelle=[epannee],
epannelles=[epannees],
epele=[epee],
epeles=[epees],
epelle=[epee],
epelles=[epees],
epila=[epia],
epilai=[epiai],
epilaient=[epiaient],
epilais=[epiais],
epilait=[epiait],
epilames=[epiames],
epilant=[epiant],
epilas=[epias],
epilasse=[epiasse],
epilassent=[epiassent],
epilasses=[epiasses],
epilassiez=[epiassiez],
epilassions=[epiassions],
epilat=[epiat],
epilates=[epiates],
epile=[epie],
epilee=[epiee],
epilees=[epiees],
epilent=[epient],
epiler=[epier],
epilera=[epiera],
epilerai=[epierai],
epileraient=[epieraient],
epilerais=[epierais],
epilerait=[epierait],
epileras=[epieras],
epilerent=[epierent],
epilerez=[epierez],
epileriez=[epieriez],
epilerions=[epierions],
epilerons=[epierons],
epileront=[epieront],
epiles=[epies],
epilez=[epiez],
epiliez=[epiiez],
epilions=[epiions],
epilons=[epions],
epincele=[epincee],
epinceles=[epincees],
epouvantail=[epouvantai],
epouvantails=[epouvantais],
equivalut=[equivaut],
eraille=[eraie],
eraillent=[eraient],
eraillera=[eraiera],
eraillerai=[eraierai],
erailleraient=[eraieraient],
eraillerais=[eraierais],
eraillerait=[eraierait],
erailleras=[eraieras],
eraillerez=[eraierez],
erailleriez=[eraieriez],
eraillerions=[eraierions],
eraillerons=[eraierons],
erailleront=[eraieront],
erailles=[eraies],
essorillez=[essoriez],
essorillons=[essorions],
estampillez=[estampiez],
estampillons=[estampions],
estival=[estiva],
etoupillez=[etoupiez],
etoupillons=[etoupions],
etrangle=[etrange],
etranglement=[etrangement],
etrangler=[etranger],
etrangles=[etranges],
etriller=[etrier],
eventail=[eventai],
eventails=[eventais],
exclusions=[excusions],
experimental=[experimenta],
explosa=[exposa],
explosai=[exposai],
explosaient=[exposaient],
explosais=[exposais],
explosait=[exposait],
explosames=[exposames],
explosant=[exposant],
explosas=[exposas],
explosasse=[exposasse],
explosassent=[exposassent],
explosasses=[exposasses],
explosassiez=[exposassiez],
explosassions=[exposassions],
explosat=[exposat],
explosates=[exposates],
explose=[expose],
explosent=[exposent],
exploser=[exposer],
explosera=[exposera],
exploserai=[exposerai],
exploseraient=[exposeraient],
exploserais=[exposerais],
exploserait=[exposerait],
exploseras=[exposeras],
exploserent=[exposerent],
exploserez=[exposerez],
exploseriez=[exposeriez],
exploserions=[exposerions],
exploserons=[exposerons],
exploseront=[exposeront],
exploses=[exposes],
explosez=[exposez],
explosiez=[exposiez],
explosions=[exposions],
explosons=[exposons],
faciles=[facies],
fallut=[faut],
faluche=[fauche],
faluches=[fauches],
fanal=[fana],
federal=[federa],
fele=[fee],
feles=[fees],
felins=[feins],
fendillez=[fendiez],
fendillons=[fendions],
ferla=[fera],
ferlai=[ferai],
ferlaient=[feraient],
ferlais=[ferais],
ferlait=[ferait],
ferlas=[feras],
ferlez=[ferez],
ferliez=[feriez],
ferlions=[ferions],
ferlons=[ferons],
fermail=[fermai],
ferraillent=[ferraient],
ferule=[ferue],
ferules=[ferues],
feule=[feue],
feules=[feues],
fiel=[fie],
fiels=[fies],
fil=[fi],
fila=[fia],
filai=[fiai],
filaient=[fiaient],
filais=[fiais],
filait=[fiait],
filames=[fiames],
filant=[fiant],
filas=[fias],
filasse=[fiasse],
filassent=[fiassent],
filasses=[fiasses],
filassiez=[fiassiez],
filassions=[fiassions],
filat=[fiat],
filates=[fiates],
file=[fie],
filee=[fiee],
filees=[fiees],
filent=[fient],
filer=[fier],
filera=[fiera],
filerai=[fierai],
fileraient=[fieraient],
filerais=[fierais],
filerait=[fierait],
fileras=[fieras],
filerent=[fierent],
filerez=[fierez],
fileriez=[fieriez],
filerions=[fierions],
filerons=[fierons],
fileront=[fieront],
files=[fies],
filez=[fiez],
filiez=[fiiez],
filions=[fiions],
fillasse=[fiasse],
fillasses=[fiasses],
fille=[fie],
filles=[fies],
filleul=[fieu],
filmes=[fimes],
filon=[fion],
filons=[fions],
fils=[fis],
fla=[fa],
flache=[fache],
flacherie=[facherie],
flacheries=[facheries],
flaches=[faches],
flacon=[facon],
flaconnage=[faconnage],
flaconnages=[faconnages],
flaconnier=[faconnier],
flaconniers=[faconniers],
flacons=[facons],
flaire=[faire],
flamine=[famine],
flamines=[famines],
flana=[fana],
flanai=[fanai],
flanaient=[fanaient],
flanais=[fanais],
flanait=[fanait],
flanames=[fanames],
flanant=[fanant],
flanas=[fanas],
flanasse=[fanasse],
flanassent=[fanassent],
flanasses=[fanasses],
flanassiez=[fanassiez],
flanassions=[fanassions],
flanat=[fanat],
flanates=[fanates],
flane=[fane],
flanelle=[fanee],
flanelles=[fanees],
flanent=[fanent],
flaner=[faner],
flanera=[fanera],
flanerai=[fanerai],
flaneraient=[faneraient],
flanerais=[fanerais],
flanerait=[fanerait],
flaneras=[faneras],
flanerent=[fanerent],
flanerez=[fanerez],
flaneriez=[faneriez],
flanerions=[fanerions],
flanerons=[fanerons],
flaneront=[faneront],
flanes=[fanes],
flaneur=[faneur],
flaneurs=[faneurs],
flaneuse=[faneuse],
flaneuses=[faneuses],
flanez=[fanez],
flaniez=[faniez],
flanions=[fanions],
flanons=[fanons],
fleaux=[feaux],
fleins=[feins],
flemme=[femme],
flemmes=[femmes],
flic=[fic],
flics=[fics],
floc=[foc],
floral=[fora],
flore=[fore],
flores=[fores],
flou=[fou],
flouee=[fouee],
flouees=[fouees],
flous=[fous],
flute=[fute],
flutee=[futee],
flutees=[futees],
flutes=[futes],
foirail=[foirai],
foirails=[foirais],
folie=[foie],
folies=[foies],
fonctionnel=[fonctionne],
fonctionnels=[fonctionnes],
formel=[forme],
formelle=[formee],
formelles=[formees],
formels=[formes],
fouille=[fouie],
fouilles=[fouies],
foulage=[fouage],
foulages=[fouages],
foulee=[fouee],
foulees=[fouees],
fournil=[fourni],
fournils=[fournis],
foutral=[foutra],
foutrals=[foutras],
fractionnel=[fractionne],
fractionnelle=[fractionnee],
fractionnelles=[fractionnees],
fractionnels=[fractionnes],
frelon=[freon],
frelons=[freons],
fretillez=[fretiez],
fretillons=[fretions],
frictionnel=[frictionne],
frictionnelle=[frictionnee],
frictionnelles=[frictionnees],
frictionnels=[frictionnes],
fulls=[fus],
fusel=[fuse],
fusele=[fusee],
fuseles=[fusees],
fuselle=[fusee],
fuselles=[fusees],
fusels=[fuses],
fusillez=[fusiez],
fusillons=[fusions],
futaille=[futaie],
futailles=[futaies],
galbions=[gabions],
galgal=[gaga],
galgals=[gagas],
gantele=[gantee],
ganteles=[gantees],
gazelle=[gazee],
gazelles=[gazees],
gelai=[geai],
gelais=[geais],
gelant=[geant],
gemmail=[gemmai],
general=[genera],
glene=[gene],
glenes=[genes],
global=[goba],
globe=[gobe],
globes=[gobes],
glousse=[gousse],
glousses=[gousses],
glouterons=[gouterons],
gloutons=[goutons],
glui=[gui],
gluis=[guis],
glus=[gus],
godaillent=[godaient],
godillez=[godiez],
godillons=[godions],
goulache=[gouache],
goulaches=[gouaches],
goulet=[gouet],
goulets=[gouets],
gouvernail=[gouvernai],
gouvernails=[gouvernais],
gracile=[gracie],
graciles=[gracies],
graduel=[gradue],
graduelle=[graduee],
graduelles=[graduees],
graduels=[gradues],
grattelle=[grattee],
grattelles=[grattees],
gravelle=[gravee],
gravelles=[gravees],
gravillons=[gravions],
grela=[grea],
grelait=[greait],
grelat=[great],
grele=[gree],
greler=[greer],
greles=[grees],
grelons=[greons],
grenaillent=[grenaient],
grenele=[grenee],
greneles=[grenees],
grenelle=[grenee],
grenelles=[grenees],
grills=[gris],
grils=[gris],
grippal=[grippa],
grisaillent=[grisaient],
guelte=[guete],
gueltes=[guetes],
guilde=[guide],
guildes=[guides],
habituel=[habitue],
habituelle=[habituee],
habituelles=[habituees],
habituels=[habitues],
hall=[ha],
halte=[hate],
haltes=[hates],
halva=[hava],
halvas=[havas],
harpail=[harpai],
harpaillent=[harpaient],
harpails=[harpais],
hibernal=[hiberna],
hivernal=[hiverna],
hormonal=[hormona],
hostile=[hostie],
hostiles=[hosties],
hotel=[hote],
hotels=[hotes],
houle=[houe],
houles=[houes],
houlque=[houque],
houlques=[houques],
huilez=[huiez],
huilons=[huions],
humeral=[humera],
hurle=[hure],
hurles=[hures],
hurlons=[hurons],
ideel=[idee],
ideels=[idees],
implosa=[imposa],
implosai=[imposai],
implosaient=[imposaient],
implosais=[imposais],
implosait=[imposait],
implosames=[imposames],
implosant=[imposant],
implosas=[imposas],
implosasse=[imposasse],
implosassent=[imposassent],
implosasses=[imposasses],
implosassiez=[imposassiez],
implosassions=[imposassions],
implosat=[imposat],
implosates=[imposates],
implose=[impose],
implosent=[imposent],
imploser=[imposer],
implosera=[imposera],
imploserai=[imposerai],
imploseraient=[imposeraient],
imploserais=[imposerais],
imploserait=[imposerait],
imploseras=[imposeras],
imploserent=[imposerent],
imploserez=[imposerez],
imploseriez=[imposeriez],
imploserions=[imposerions],
imploserons=[imposerons],
imploseront=[imposeront],
imploses=[imposes],
implosez=[imposez],
implosiez=[imposiez],
implosions=[imposions],
implosons=[imposons],
inaugural=[inaugura],
inclinera=[incinera],
inclinerai=[incinerai],
inclineraient=[incineraient],
inclinerais=[incinerais],
inclinerait=[incinerait],
inclineras=[incineras],
inclinerent=[incinerent],
inclinerez=[incinerez],
inclineriez=[incineriez],
inclinerions=[incinerions],
inclinerons=[incinerons],
incluse=[incuse],
incluses=[incuses],
inconditionnel=[inconditionne],
inconditionnelle=[inconditionnee],
inconditionnelles=[inconditionnees],
inconditionnels=[inconditionnes],
incorporel=[incorpore],
incorporelle=[incorporee],
incorporelles=[incorporees],
incorporels=[incorpores],
industriel=[industrie],
industriels=[industries],
inertiel=[inertie],
inertiels=[inerties],
informel=[informe],
informelle=[informee],
informelles=[informees],
informels=[informes],
initial=[initia],
integral=[integra],
intentionnel=[intentionne],
intentionnelle=[intentionnee],
intentionnelles=[intentionnees],
intentionnels=[intentionnes],
intersexuel=[intersexue],
intersexuelle=[intersexuee],
intersexuelles=[intersexuees],
intersexuels=[intersexues],
iodla=[ioda],
iodlai=[iodai],
iodlaient=[iodaient],
iodlais=[iodais],
iodlait=[iodait],
iodlames=[iodames],
iodlant=[iodant],
iodlas=[iodas],
iodlasse=[iodasse],
iodlassent=[iodassent],
iodlasses=[iodasses],
iodlassiez=[iodassiez],
iodlassions=[iodassions],
iodlat=[iodat],
iodlates=[iodates],
iodle=[iode],
iodlee=[iodee],
iodlees=[iodees],
iodlent=[iodent],
iodler=[ioder],
iodlera=[iodera],
iodlerai=[ioderai],
iodleraient=[ioderaient],
iodlerais=[ioderais],
iodlerait=[ioderait],
iodleras=[ioderas],
iodlerent=[ioderent],
iodlerez=[ioderez],
iodleriez=[ioderiez],
iodlerions=[ioderions],
iodlerons=[ioderons],
iodleront=[ioderont],
iodles=[iodes],
iodlez=[iodez],
iodliez=[iodiez],
iodlions=[iodions],
iodlons=[iodons],
jarretelle=[jarretee],
jarretelles=[jarretees],
jolie=[joie],
jolies=[joies],
jouaillent=[jouaient],
joual=[joua],
joule=[joue],
joules=[joues],
kilt=[kit],
kilts=[kits],
la=[a],
lace=[ace],
lacera=[acera],
lacerai=[acerai],
laceraient=[aceraient],
lacerais=[acerais],
lacerait=[acerait],
lacerames=[acerames],
lacerant=[acerant],
laceras=[aceras],
lacerasse=[acerasse],
lacerassent=[acerassent],
lacerasses=[acerasses],
lacerassiez=[acerassiez],
lacerassions=[acerassions],
lacerat=[acerat],
lacerates=[acerates],
lacere=[acere],
laceree=[aceree],
lacerees=[acerees],
lacerent=[acerent],
lacerer=[acerer],
lacerera=[acerera],
lacererai=[acererai],
lacereraient=[acereraient],
lacererais=[acererais],
lacererait=[acererait],
lacereras=[acereras],
lacererent=[acererent],
lacererez=[acererez],
lacereriez=[acereriez],
lacererions=[acererions],
lacererons=[acererons],
lacereront=[acereront],
laceres=[aceres],
lacerez=[acerez],
laceriez=[aceriez],
lacerions=[acerions],
lacerons=[acerons],
laces=[aces],
lachat=[achat],
lachete=[achete],
lachetes=[achetes],
lacons=[acons],
lactates=[actates],
lacte=[acte],
lactee=[actee],
lactees=[actees],
lactes=[actes],
laguis=[aguis],
lai=[ai],
laiche=[aiche],
laiches=[aiches],
laide=[aide],
laiderons=[aiderons],
laides=[aides],
laie=[aie],
laient=[aient],
laies=[aies],
laine=[aine],
lainee=[ainee],
lainees=[ainees],
laines=[aines],
lais=[ais],
lait=[ait],
lamant=[amant],
lamas=[amas],
lamasse=[amasse],
lamassent=[amassent],
lamasses=[amasses],
lamassiez=[amassiez],
lamassions=[amassions],
lame=[ame],
lamer=[amer],
lames=[ames],
lamie=[amie],
lamies=[amies],
lamine=[amine],
laminee=[aminee],
laminees=[aminees],
lamines=[amines],
lange=[ange],
langes=[anges],
lanier=[anier],
laniere=[aniere],
lanieres=[anieres],
laniers=[aniers],
lapions=[apions],
lapis=[apis],
laqueuse=[aqueuse],
laqueuses=[aqueuses],
laqueux=[aqueux],
laraire=[araire],
laraires=[araires],
lardent=[ardent],
largua=[argua],
larguai=[arguai],
larguaient=[arguaient],
larguais=[arguais],
larguait=[arguait],
larguames=[arguames],
larguant=[arguant],
larguas=[arguas],
larguasse=[arguasse],
larguassent=[arguassent],
larguasses=[arguasses],
larguassiez=[arguassiez],
larguassions=[arguassions],
larguat=[arguat],
larguates=[arguates],
largue=[argue],
larguee=[arguee],
larguees=[arguees],
larguent=[arguent],
larguer=[arguer],
larguera=[arguera],
larguerai=[arguerai],
largueraient=[argueraient],
larguerais=[arguerais],
larguerait=[arguerait],
largueras=[argueras],
larguerent=[arguerent],
larguerez=[arguerez],
largueriez=[argueriez],
larguerions=[arguerions],
larguerons=[arguerons],
largueront=[argueront],
largues=[argues],
larguez=[arguez],
larguiez=[arguiez],
larguions=[arguions],
larguons=[arguons],
larme=[arme],
larmes=[armes],
las=[as],
lassai=[assai],
lasse=[asse],
lasses=[asses],
lassez=[assez],
lassis=[assis],
lavaient=[avaient],
lavais=[avais],
lavait=[avait],
lavant=[avant],
lave=[ave],
lavera=[avera],
laverai=[averai],
laveraient=[averaient],
laverais=[averais],
laverait=[averait],
laveras=[averas],
laverent=[averent],
laverez=[averez],
laveriez=[averiez],
laverions=[averions],
laverons=[averons],
lavez=[avez],
laviez=[aviez],
lavions=[avions],
lavis=[avis],
lavoir=[avoir],
lavons=[avons],
layant=[ayant],
layez=[ayez],
layons=[ayons],
lazurite=[azurite],
lazurites=[azurites],
lechasse=[echasse],
lechasses=[echasses],
leche=[eche],
leches=[eches],
ledit=[edit],
legaux=[egaux],
lente=[ente],
lentes=[entes],
lentillons=[entions],
les=[es],
lest=[est],
lester=[ester],
let=[et],
letaux=[etaux],
leu=[eu],
levent=[event],
levier=[evier],
leviers=[eviers],
levite=[evite],
levites=[evites],
libere=[ibere],
liberes=[iberes],
lignames=[ignames],
ligne=[igne],
lignee=[ignee],
lignees=[ignees],
lignes=[ignes],
ligue=[igue],
ligues=[igues],
ligule=[igue],
ligules=[igues],
limage=[image],
limages=[images],
limita=[imita],
limitai=[imitai],
limitaient=[imitaient],
limitais=[imitais],
limitait=[imitait],
limitames=[imitames],
limitant=[imitant],
limitas=[imitas],
limitasse=[imitasse],
limitassent=[imitassent],
limitasses=[imitasses],
limitassiez=[imitassiez],
limitassions=[imitassions],
limitat=[imitat],
limitates=[imitates],
limitatif=[imitatif],
limitatifs=[imitatifs],
limitation=[imitation],
limitations=[imitations],
limitative=[imitative],
limitatives=[imitatives],
limite=[imite],
limitee=[imitee],
limitees=[imitees],
limitent=[imitent],
limiter=[imiter],
limitera=[imitera],
limiterai=[imiterai],
limiteraient=[imiteraient],
limiterais=[imiterais],
limiterait=[imiterait],
limiteras=[imiteras],
limiterent=[imiterent],
limiterez=[imiterez],
limiteriez=[imiteriez],
limiterions=[imiterions],
limiterons=[imiterons],
limiteront=[imiteront],
limites=[imites],
limitez=[imitez],
limitiez=[imitiez],
limitions=[imitions],
limitons=[imitons],
lin=[in],
lingera=[ingera],
lingerai=[ingerai],
lingeraient=[ingeraient],
lingerais=[ingerais],
lingerait=[ingerait],
lingeras=[ingeras],
lingere=[ingere],
lingerent=[ingerent],
lingeres=[ingeres],
lingerez=[ingerez],
lingeriez=[ingeriez],
lingerions=[ingerions],
lingerons=[ingerons],
linter=[inter],
lion=[ion],
lions=[ions],
lira=[ira],
lirai=[irai],
liraient=[iraient],
lirais=[irais],
lirait=[irait],
liras=[iras],
lire=[ire],
lirez=[irez],
liriez=[iriez],
lirions=[irions],
lirons=[irons],
liront=[iront],
lissant=[issant],
lissante=[issante],
lissantes=[issantes],
lissants=[issants],
litera=[itera],
literai=[iterai],
literaient=[iteraient],
literais=[iterais],
literait=[iterait],
literas=[iteras],
literent=[iterent],
literez=[iterez],
literiez=[iteriez],
literions=[iterions],
literons=[iterons],
live=[ive],
lives=[ives],
livre=[ivre],
livres=[ivres],
lobera=[obera],
loberai=[oberai],
loberaient=[oberaient],
loberais=[oberais],
loberait=[oberait],
loberas=[oberas],
loberent=[oberent],
loberez=[oberez],
loberiez=[oberiez],
loberions=[oberions],
loberons=[oberons],
lois=[ois],
lors=[ors],
lote=[ote],
lotes=[otes],
lotions=[otions],
lotites=[otites],
louais=[ouais],
louates=[ouates],
louche=[ouche],
louches=[ouches],
louis=[ouis],
loutre=[outre],
loutres=[outres],
lovates=[ovates],
love=[ove],
loves=[oves],
lune=[une],
lunes=[unes],
lus=[us],
lut=[ut],
machinal=[machina],
maclera=[macera],
maclerai=[macerai],
macleraient=[maceraient],
maclerais=[macerais],
maclerait=[macerait],
macleras=[maceras],
maclerent=[macerent],
maclerez=[macerez],
macleriez=[maceriez],
maclerions=[macerions],
maclerons=[macerons],
maclons=[macons],
mail=[mai],
mailla=[maia],
maillas=[maias],
maille=[maie],
mailles=[maies],
mails=[mais],
majoral=[majora],
mal=[ma],
mali=[mai],
malin=[main],
malins=[mains],
malis=[mais],
malt=[mat],
malta=[mata],
maltage=[matage],
maltages=[matages],
maltai=[matai],
maltaient=[mataient],
maltais=[matais],
maltait=[matait],
maltames=[matames],
maltant=[matant],
maltas=[matas],
maltasse=[matasse],
maltassent=[matassent],
maltasses=[matasses],
maltassiez=[matassiez],
maltassions=[matassions],
maltat=[matat],
maltates=[matates],
malte=[mate],
maltee=[matee],
maltees=[matees],
maltent=[matent],
malter=[mater],
maltera=[matera],
malterai=[materai],
malteraient=[materaient],
malterais=[materais],
malterait=[materait],
malteras=[materas],
malterent=[materent],
malterez=[materez],
malteriez=[materiez],
malterions=[materions],
malterons=[materons],
malteront=[materont],
maltes=[mates],
maltez=[matez],
maltiez=[matiez],
maltions=[mations],
maltons=[matons],
malts=[mats],
mandorle=[mandore],
mandorles=[mandores],
manille=[manie],
manilles=[manies],
manillons=[manions],
maquillez=[maquiez],
maquillons=[maquions],
marelle=[maree],
marelles=[marees],
margelle=[margee],
margelles=[margees],
marginal=[margina],
marial=[maria],
marials=[marias],
marli=[mari],
marlis=[maris],
martel=[marte],
maternel=[materne],
maternelle=[maternee],
maternelles=[maternees],
maternels=[maternes],
matinal=[matina],
maximal=[maxima],
medial=[media],
melat=[meat],
menstruels=[menstrues],
merle=[mere],
merles=[meres],
metal=[meta],
miel=[mie],
miels=[mies],
mil=[mi],
mile=[mie],
miles=[mies],
mille=[mie],
milles=[mies],
mils=[mis],
mineral=[minera],
minimal=[minima],
missel=[misse],
missels=[misses],
molli=[moi],
mollira=[moira],
mollirai=[moirai],
molliraient=[moiraient],
mollirais=[moirais],
mollirait=[moirait],
molliras=[moiras],
mollirent=[moirent],
mollirez=[moirez],
molliriez=[moiriez],
mollirions=[moirions],
mollirons=[moirons],
mollis=[mois],
mollissons=[moissons],
mollites=[moites],
mordillez=[mordiez],
mordillons=[mordions],
morillon=[morion],
morillons=[morions],
mortel=[morte],
mortels=[mortes],
mouflette=[moufette],
mouflettes=[moufettes],
moule=[moue],
moules=[moues],
moult=[mout],
mule=[mue],
mules=[mues],
mulet=[muet],
mulets=[muets],
mulette=[muette],
mulettes=[muettes],
mulons=[muons],
mulsions=[musions],
muraillent=[muraient],
mural=[mura],
musclat=[muscat],
musele=[musee],
museles=[musees],
muselle=[musee],
muselles=[musees],
mutilez=[mutiez],
mutilons=[mutions],
naturel=[nature],
naturels=[natures],
nielle=[niee],
nielles=[niees],
nille=[nie],
nilles=[nies],
nolise=[noise],
nolises=[noises],
nopal=[nopa],
nopals=[nopas],
nul=[nu],
nulle=[nue],
nulles=[nues],
nullite=[nuite],
nullites=[nuites],
nuls=[nus],
objectal=[objecta],
occasionnel=[occasionne],
occasionnelle=[occasionnee],
occasionnelles=[occasionnees],
occasionnels=[occasionnes],
official=[officia],
officiel=[officie],
officiels=[officies],
oille=[oie],
oilles=[oies],
ombrelle=[ombree],
ombrelles=[ombrees],
oncle=[once],
oncles=[onces],
optimal=[optima],
orbital=[orbita],
orchestral=[orchestra],
oriental=[orienta],
originel=[origine],
originels=[origines],
orles=[ores],
ornemental=[ornementa],
ouille=[ouie],
ouilles=[ouies],
pagaille=[pagaie],
pagailles=[pagaies],
pagel=[page],
pagels=[pages],
paille=[paie],
paillent=[paient],
paillera=[paiera],
paillerai=[paierai],
pailleraient=[paieraient],
paillerais=[paierais],
paillerait=[paierait],
pailleras=[paieras],
paillerez=[paierez],
pailleriez=[paieriez],
paillerions=[paierions],
paillerons=[paierons],
pailleront=[paieront],
pailles=[paies],
pairle=[paire],
pairles=[paires],
palie=[paie],
palies=[paies],
palir=[pair],
palis=[pais],
palissaient=[paissaient],
palissais=[paissais],
palissait=[paissait],
palissant=[paissant],
palisse=[paisse],
palissent=[paissent],
palisses=[paisses],
palissez=[paissez],
palissiez=[paissiez],
palissions=[paissions],
palissons=[paissons],
palit=[pait],
pallie=[paie],
pallient=[paient],
palliera=[paiera],
pallierai=[paierai],
pallieraient=[paieraient],
pallierais=[paierais],
pallierait=[paierait],
pallieras=[paieras],
pallierez=[paierez],
pallieriez=[paieriez],
pallierions=[paierions],
pallierons=[paierons],
pallieront=[paieront],
pallies=[paies],
palma=[pama],
palmai=[pamai],
palmaient=[pamaient],
palmais=[pamais],
palmait=[pamait],
palmames=[pamames],
palmant=[pamant],
palmas=[pamas],
palmasse=[pamasse],
palmassent=[pamassent],
palmasses=[pamasses],
palmassiez=[pamassiez],
palmassions=[pamassions],
palmat=[pamat],
palmates=[pamates],
palme=[pame],
palmee=[pamee],
palmees=[pamees],
palment=[pament],
palmer=[pamer],
palmera=[pamera],
palmerai=[pamerai],
palmeraient=[pameraient],
palmerais=[pamerais],
palmerait=[pamerait],
palmeras=[pameras],
palmerent=[pamerent],
palmerez=[pamerez],
palmeriez=[pameriez],
palmerions=[pamerions],
palmerons=[pamerons],
palmeront=[pameront],
palmes=[pames],
palmez=[pamez],
palmiez=[pamiez],
palmions=[pamions],
palmons=[pamons],
palpa=[papa],
palpas=[papas],
palpe=[pape],
palpes=[papes],
palpions=[papions],
pals=[pas],
panel=[pane],
panels=[panes],
papal=[papa],
papillon=[papion],
papillons=[papions],
parla=[para],
parlai=[parai],
parlaient=[paraient],
parlais=[parais],
parlait=[parait],
parlames=[parames],
parlant=[parant],
parlas=[paras],
parlasse=[parasse],
parlassent=[parassent],
parlasses=[parasses],
parlassiez=[parassiez],
parlassions=[parassions],
parlat=[parat],
parlates=[parates],
parle=[pare],
parlee=[paree],
parlees=[parees],
parlement=[parement],
parlementa=[parementa],
parlementai=[parementai],
parlementaient=[parementaient],
parlementais=[parementais],
parlementait=[parementait],
parlementames=[parementames],
parlementant=[parementant],
parlementas=[parementas],
parlementasse=[parementasse],
parlementassent=[parementassent],
parlementasses=[parementasses],
parlementassiez=[parementassiez],
parlementassions=[parementassions],
parlementat=[parementat],
parlementates=[parementates],
parlemente=[paremente],
parlementent=[parementent],
parlementer=[parementer],
parlementera=[parementera],
parlementerai=[parementerai],
parlementeraient=[parementeraient],
parlementerais=[parementerais],
parlementerait=[parementerait],
parlementeras=[parementeras],
parlementerent=[parementerent],
parlementerez=[parementerez],
parlementeriez=[parementeriez],
parlementerions=[parementerions],
parlementerons=[parementerons],
parlementeront=[parementeront],
parlementes=[parementes],
parlementez=[parementez],
parlementiez=[parementiez],
parlementions=[parementions],
parlementons=[parementons],
parlements=[parements],
parlent=[parent],
parler=[parer],
parlera=[parera],
parlerai=[parerai],
parleras=[pareras],
parlerent=[parerent],
parles=[pares],
parleur=[pareur],
parleurs=[pareurs],
parleuse=[pareuse],
parleuses=[pareuses],
parlez=[parez],
parliez=[pariez],
parlions=[parions],
parlons=[parons],
paroli=[paroi],
partiel=[partie],
partiels=[parties],
passionnel=[passionne],
passionnelle=[passionnee],
passionnelles=[passionnees],
passionnels=[passionnes],
patelle=[patee],
patelles=[patees],
paternel=[paterne],
paternels=[paternes],
paumelle=[paumee],
paumelles=[paumees],
pavillons=[pavions],
pelage=[peage],
pelages=[peages],
pelons=[peons],
pelta=[peta],
peltas=[petas],
pelte=[pete],
peltee=[petee],
peltees=[petees],
peltes=[petes],
pendillez=[pendiez],
pendillons=[pendions],
pendule=[pendue],
pendules=[pendues],
penils=[penis],
perclus=[percus],
peril=[peri],
perils=[peris],
perle=[pere],
perles=[peres],
perlot=[perot],
perlots=[perots],
perpetuel=[perpetue],
perpetuelle=[perpetuee],
perpetuelles=[perpetuees],
perpetuels=[perpetues],
persel=[perse],
persels=[perses],
personnel=[personne],
personnels=[personnes],
petillez=[petiez],
petillons=[petions],
petrel=[petre],
petrels=[petres],
peul=[peu],
pilaf=[piaf],
pilafs=[piafs],
pilastre=[piastre],
pilastres=[piastres],
pile=[pie],
piles=[pies],
pileuse=[pieuse],
pileuses=[pieuses],
pileux=[pieux],
pille=[pie],
pilles=[pies],
pilleuse=[pieuse],
pilleuses=[pieuses],
pilleux=[pieux],
pillons=[pions],
pilon=[pion],
pilonna=[pionna],
pilonnai=[pionnai],
pilonnaient=[pionnaient],
pilonnais=[pionnais],
pilonnait=[pionnait],
pilonnames=[pionnames],
pilonnant=[pionnant],
pilonnas=[pionnas],
pilonnasse=[pionnasse],
pilonnassent=[pionnassent],
pilonnasses=[pionnasses],
pilonnassiez=[pionnassiez],
pilonnassions=[pionnassions],
pilonnat=[pionnat],
pilonnates=[pionnates],
pilonne=[pionne],
pilonnent=[pionnent],
pilonner=[pionner],
pilonnera=[pionnera],
pilonnerai=[pionnerai],
pilonneraient=[pionneraient],
pilonnerais=[pionnerais],
pilonnerait=[pionnerait],
pilonneras=[pionneras],
pilonnerent=[pionnerent],
pilonnerez=[pionnerez],
pilonneriez=[pionneriez],
pilonnerions=[pionnerions],
pilonnerons=[pionnerons],
pilonneront=[pionneront],
pilonnes=[pionnes],
pilonnez=[pionnez],
pilonniez=[pionniez],
pilonnions=[pionnions],
pilonnons=[pionnons],
pilons=[pions],
placage=[pacage],
placages=[pacages],
plage=[page],
plages=[pages],
plagiez=[pagiez],
plagions=[pagions],
plaie=[paie],
plaies=[paies],
plains=[pains],
plaire=[paire],
plais=[pais],
plait=[pait],
plan=[pan],
plana=[pana],
planai=[panai],
planaient=[panaient],
planais=[panais],
planait=[panait],
planames=[panames],
planant=[panant],
planas=[panas],
planasse=[panasse],
planassent=[panassent],
planasses=[panasses],
planassiez=[panassiez],
planassions=[panassions],
planat=[panat],
planates=[panates],
plane=[pane],
planee=[panee],
planees=[panees],
planent=[panent],
planer=[paner],
planera=[panera],
planerai=[panerai],
planeraient=[paneraient],
planerais=[panerais],
planerait=[panerait],
planeras=[paneras],
planerent=[panerent],
planerez=[panerez],
planeriez=[paneriez],
planerions=[panerions],
planerons=[panerons],
planeront=[paneront],
planes=[panes],
planez=[panez],
planiez=[paniez],
planifia=[panifia],
planifiai=[panifiai],
planifiaient=[panifiaient],
planifiais=[panifiais],
planifiait=[panifiait],
planifiames=[panifiames],
planifiant=[panifiant],
planifias=[panifias],
planifiasse=[panifiasse],
planifiassent=[panifiassent],
planifiasses=[panifiasses],
planifiassiez=[panifiassiez],
planifiassions=[panifiassions],
planifiat=[panifiat],
planifiates=[panifiates],
planification=[panification],
planifications=[panifications],
planifie=[panifie],
planifiee=[panifiee],
planifiees=[panifiees],
planifient=[panifient],
planifier=[panifier],
planifiera=[panifiera],
planifierai=[panifierai],
planifieraient=[panifieraient],
planifierais=[panifierais],
planifierait=[panifierait],
planifieras=[panifieras],
planifierent=[panifierent],
planifierez=[panifierez],
planifieriez=[panifieriez],
planifierions=[panifierions],
planifierons=[panifierons],
planifieront=[panifieront],
planifies=[panifies],
planifiez=[panifiez],
planifiiez=[panifiiez],
planifiions=[panifiions],
planifions=[panifions],
planions=[panions],
planons=[panons],
plans=[pans],
plaque=[paque],
plaques=[paques],
plat=[pat],
plate=[pate],
platee=[patee],
platees=[patees],
plates=[pates],
platina=[patina],
platinage=[patinage],
platinages=[patinages],
platinai=[patinai],
platinaient=[patinaient],
platinais=[patinais],
platinait=[patinait],
platinames=[patinames],
platinant=[patinant],
platinas=[patinas],
platinasse=[patinasse],
platinassent=[patinassent],
platinasses=[patinasses],
platinassiez=[patinassiez],
platinassions=[patinassions],
platinat=[patinat],
platinates=[patinates],
platine=[patine],
platinee=[patinee],
platinees=[patinees],
platinent=[patinent],
platiner=[patiner],
platinera=[patinera],
platinerai=[patinerai],
platineraient=[patineraient],
platinerais=[patinerais],
platinerait=[patinerait],
platineras=[patineras],
platinerent=[patinerent],
platinerez=[patinerez],
platineriez=[patineriez],
platinerions=[patinerions],
platinerons=[patinerons],
platineront=[patineront],
platines=[patines],
platinez=[patinez],
platiniez=[patiniez],
platinions=[patinions],
platinons=[patinons],
platre=[patre],
platres=[patres],
platrons=[patrons],
playons=[payons],
pleine=[peine],
pleines=[peines],
pleins=[peins],
pleur=[peur],
pleureuse=[peureuse],
pleureuses=[peureuses],
pleurs=[peurs],
pleut=[peut],
pleuvent=[peuvent],
pli=[pi],
plie=[pie],
plies=[pies],
plieuse=[pieuse],
plieuses=[pieuses],
plions=[pions],
plique=[pique],
pliques=[piques],
plis=[pis],
plissa=[pissa],
plissai=[pissai],
plissaient=[pissaient],
plissais=[pissais],
plissait=[pissait],
plissames=[pissames],
plissant=[pissant],
plissas=[pissas],
plissasse=[pissasse],
plissassent=[pissassent],
plissasses=[pissasses],
plissassiez=[pissassiez],
plissassions=[pissassions],
plissat=[pissat],
plissates=[pissates],
plisse=[pisse],
plissee=[pissee],
plissees=[pissees],
plissent=[pissent],
plisser=[pisser],
plissera=[pissera],
plisserai=[pisserai],
plisseraient=[pisseraient],
plisserais=[pisserais],
plisserait=[pisserait],
plisseras=[pisseras],
plisserent=[pisserent],
plisserez=[pisserez],
plisseriez=[pisseriez],
plisserions=[pisserions],
plisserons=[pisserons],
plisseront=[pisseront],
plisses=[pisses],
plisseur=[pisseur],
plisseurs=[pisseurs],
plisseuse=[pisseuse],
plisseuses=[pisseuses],
plissez=[pissez],
plissiez=[pissiez],
plissions=[pissions],
plissons=[pissons],
plonge=[ponge],
plongee=[pongee],
plongees=[pongees],
plonges=[ponges],
ploqua=[poqua],
ploquai=[poquai],
ploquaient=[poquaient],
ploquais=[poquais],
ploquait=[poquait],
ploquames=[poquames],
ploquant=[poquant],
ploquas=[poquas],
ploquasse=[poquasse],
ploquassent=[poquassent],
ploquasses=[poquasses],
ploquassiez=[poquassiez],
ploquassions=[poquassions],
ploquat=[poquat],
ploquates=[poquates],
ploque=[poque],
ploquent=[poquent],
ploquer=[poquer],
ploquera=[poquera],
ploquerai=[poquerai],
ploqueraient=[poqueraient],
ploquerais=[poquerais],
ploquerait=[poquerait],
ploqueras=[poqueras],
ploquerent=[poquerent],
ploquerez=[poquerez],
ploqueriez=[poqueriez],
ploquerions=[poquerions],
ploquerons=[poquerons],
ploqueront=[poqueront],
ploques=[poques],
ploquez=[poquez],
ploquiez=[poquiez],
ploquions=[poquions],
ploquons=[poquons],
plot=[pot],
plots=[pots],
plouf=[pouf],
plu=[pu],
pluche=[puche],
pluches=[puches],
plucheux=[pucheux],
pluma=[puma],
plumas=[pumas],
plumes=[pumes],
plurent=[purent],
plus=[pus],
plusse=[pusse],
plussent=[pussent],
plusses=[pusses],
plussiez=[pussiez],
plussions=[pussions],
plut=[put],
plutes=[putes],
poils=[pois],
pointal=[pointa],
pointillez=[pointiez],
pointillons=[pointions],
polis=[pois],
polissaient=[poissaient],
polissais=[poissais],
polissait=[poissait],
polissant=[poissant],
polisse=[poisse],
polissent=[poissent],
polisses=[poisses],
polisseuse=[poisseuse],
polisseuses=[poisseuses],
polissez=[poissez],
polissiez=[poissiez],
polissions=[poissions],
polisson=[poisson],
polissonnerie=[poissonnerie],
polissonneries=[poissonneries],
polissons=[poissons],
ponctuel=[ponctue],
ponctuelle=[ponctuee],
ponctuelles=[ponctuees],
ponctuels=[ponctues],
ponderal=[pondera],
pontiller=[pontier],
pontillez=[pontiez],
pontillons=[pontions],
portail=[portai],
portails=[portais],
portillon=[portion],
portillons=[portions],
postal=[posta],
postillons=[postions],
potele=[potee],
poteles=[potees],
poulpe=[poupe],
poulpes=[poupes],
poult-de-soie=[pout-de-soie],
poults-de-soie=[pouts-de-soie],
prejudiciel=[prejudicie],
prejudiciels=[prejudicies],
prevalut=[prevaut],
processionnel=[processionne],
processionnels=[processionnes],
proportionnel=[proportionne],
proportionnelle=[proportionnee],
proportionnelles=[proportionnees],
proportionnels=[proportionnes],
protele=[protee],
proteles=[protees],
pull=[pu],
pulls=[pus],
pulpe=[pupe],
pulpes=[pupes],
pyramidal=[pyramida],
quel=[que],
rablais=[rabais],
rablat=[rabat],
racinal=[racina],
racle=[race],
raclee=[racee],
raclees=[racees],
racler=[racer],
racles=[races],
radial=[radia],
rail=[rai],
railla=[raia],
raillas=[raias],
raille=[raie],
raillent=[raient],
raillera=[raiera],
raillerai=[raierai],
railleraient=[raieraient],
raillerais=[raierais],
raillerait=[raierait],
railleras=[raieras],
raillerez=[raierez],
railleriez=[raieriez],
raillerions=[raierions],
raillerons=[raierons],
railleront=[raieront],
railles=[raies],
rails=[rais],
rallia=[raia],
rallias=[raias],
rallie=[raie],
rallient=[raient],
ralliera=[raiera],
rallierai=[raierai],
rallieraient=[raieraient],
rallierais=[raierais],
rallierait=[raierait],
rallieras=[raieras],
rallierez=[raierez],
rallieriez=[raieriez],
rallierions=[raierions],
rallierons=[raierons],
rallieront=[raieront],
rallies=[raies],
rallye=[raye],
rallyes=[rayes],
ramaillent=[ramaient],
ramille=[ramie],
ramilles=[ramies],
ratel=[rate],
ratele=[ratee],
rateles=[ratees],
ratelle=[ratee],
ratelles=[ratees],
ratels=[rates],
rationnel=[rationne],
rationnelle=[rationnee],
rationnelles=[rationnees],
rationnels=[rationnes],
real=[rea],
recels=[reces],
recital=[recita],
recitals=[recitas],
reclure=[recure],
reclus=[recus],
recluse=[recuse],
recluses=[recuses],
reclusions=[recusions],
rectal=[recta],
recul=[recu],
recule=[recue],
recules=[recues],
reel=[ree],
reels=[rees],
reflection=[refection],
reflections=[refections],
reglates=[regates],
reglent=[regent],
reglions=[regions],
reglisse=[regisse],
reglisses=[regisses],
relaient=[reaient],
relais=[reais],
relates=[reates],
relent=[reent],
reliez=[reiez],
relions=[reions],
relis=[reis],
reparla=[repara],
reparlai=[reparai],
reparlaient=[reparaient],
reparlais=[reparais],
reparlait=[reparait],
reparlames=[reparames],
reparlant=[reparant],
reparlas=[reparas],
reparlasse=[reparasse],
reparlassent=[reparassent],
reparlasses=[reparasses],
reparlassiez=[reparassiez],
reparlassions=[reparassions],
reparlat=[reparat],
reparlates=[reparates],
reparle=[repare],
reparlent=[reparent],
reparler=[reparer],
reparlera=[reparera],
reparlerai=[reparerai],
reparleraient=[repareraient],
reparlerais=[reparerais],
reparlerait=[reparerait],
reparleras=[repareras],
reparlerent=[reparerent],
reparlerez=[reparerez],
reparleriez=[repareriez],
reparlerions=[reparerions],
reparlerons=[reparerons],
reparleront=[repareront],
reparles=[repares],
reparlez=[reparez],
reparliez=[repariez],
reparlions=[reparions],
reparlons=[reparons],
replete=[repete],
repletes=[repetes],
repletions=[repetions],
repliqua=[repiqua],
repliquai=[repiquai],
repliquaient=[repiquaient],
repliquais=[repiquais],
repliquait=[repiquait],
repliquames=[repiquames],
repliquant=[repiquant],
repliquas=[repiquas],
repliquasse=[repiquasse],
repliquassent=[repiquassent],
repliquasses=[repiquasses],
repliquassiez=[repiquassiez],
repliquassions=[repiquassions],
repliquat=[repiquat],
repliquates=[repiquates],
replique=[repique],
repliquee=[repiquee],
repliquees=[repiquees],
repliquent=[repiquent],
repliquer=[repiquer],
repliquera=[repiquera],
repliquerai=[repiquerai],
repliqueraient=[repiqueraient],
repliquerais=[repiquerais],
repliquerait=[repiquerait],
repliqueras=[repiqueras],
repliquerent=[repiquerent],
repliquerez=[repiquerez],
repliqueriez=[repiqueriez],
repliquerions=[repiquerions],
repliquerons=[repiquerons],
repliqueront=[repiqueront],
repliques=[repiques],
repliquez=[repiquez],
repliquiez=[repiquiez],
repliquions=[repiquions],
repliquons=[repiquons],
replu=[repu],
replurent=[repurent],
replussent=[repussent],
replut=[reput],
resolus=[resous],
resolut=[resout],
resolutes=[resoutes],
ressemele=[ressemee],
ressemeles=[ressemees],
ressemelle=[ressemee],
ressemelles=[ressemees],
revaillent=[revaient],
revalut=[revaut],
revele=[revee],
reveles=[revees],
revolta=[revota],
revoltai=[revotai],
revoltaient=[revotaient],
revoltais=[revotais],
revoltait=[revotait],
revoltames=[revotames],
revoltant=[revotant],
revoltas=[revotas],
revoltasse=[revotasse],
revoltassent=[revotassent],
revoltasses=[revotasses],
revoltassiez=[revotassiez],
revoltassions=[revotassions],
revoltat=[revotat],
revoltates=[revotates],
revolte=[revote],
revoltee=[revotee],
revoltees=[revotees],
revoltent=[revotent],
revolter=[revoter],
revoltera=[revotera],
revolterai=[revoterai],
revolteraient=[revoteraient],
revolterais=[revoterais],
revolterait=[revoterait],
revolteras=[revoteras],
revolterent=[revoterent],
revolterez=[revoterez],
revolteriez=[revoteriez],
revolterions=[revoterions],
revolterons=[revoterons],
revolteront=[revoteront],
revoltes=[revotes],
revoltez=[revotez],
revoltiez=[revotiez],
revoltions=[revotions],
revoltons=[revotons],
rial=[ria],
rials=[rias],
ridelle=[ridee],
ridelles=[ridees],
riel=[rie],
riels=[ries],
rillons=[rions],
rimaillent=[rimaient],
ripaillent=[ripaient],
rival=[riva],
rodaillent=[rodaient],
rouelle=[rouee],
rouelles=[rouees],
rouille=[rouie],
rouilles=[rouies],
rouillez=[rouiez],
rouillons=[rouions],
roula=[roua],
roulage=[rouage],
roulages=[rouages],
roulai=[rouai],
roulaient=[rouaient],
roulais=[rouais],
roulait=[rouait],
roulames=[rouames],
roulant=[rouant],
roulas=[rouas],
roulasse=[rouasse],
roulassent=[rouassent],
roulasses=[rouasses],
roulassiez=[rouassiez],
roulassions=[rouassions],
roulat=[rouat],
roulates=[rouates],
roule=[roue],
roulee=[rouee],
roulees=[rouees],
roulent=[rouent],
rouler=[rouer],
roulera=[rouera],
roulerai=[rouerai],
rouleraient=[roueraient],
roulerais=[rouerais],
roulerait=[rouerait],
rouleras=[roueras],
roulerent=[rouerent],
roulerez=[rouerez],
rouleriez=[roueriez],
roulerions=[rouerions],
roulerons=[rouerons],
rouleront=[roueront],
roules=[roues],
roulette=[rouette],
roulettes=[rouettes],
roulez=[rouez],
rouliez=[rouiez],
roulions=[rouions],
roulis=[rouis],
roulons=[rouons],
roupille=[roupie],
roupilles=[roupies],
ruelle=[ruee],
ruelles=[ruees],
ruilez=[ruiez],
ruilons=[ruions],
sacral=[sacra],
sali=[sai],
salignons=[saignons],
salin=[sain],
saline=[saine],
salines=[saines],
salins=[sains],
salis=[sais],
salit=[sait],
salites=[saites],
salure=[saure],
salures=[saures],
salut=[saut],
saluts=[sauts],
sautelle=[sautee],
sautelles=[sautees],
sautillez=[sautiez],
sautillons=[sautions],
scille=[scie],
scilles=[scies],
segmental=[segmenta],
sel=[se],
sellant=[seant],
sels=[ses],
selve=[seve],
selves=[seves],
semelle=[semee],
semelles=[semees],
semillons=[semions],
serail=[serai],
serails=[serais],
seriel=[serie],
serielle=[seriee],
serielles=[seriees],
seriels=[series],
servile=[servie],
serviles=[servies],
sexuel=[sexue],
sexuelle=[sexuee],
sexuelles=[sexuees],
sexuels=[sexues],
sideral=[sidera],
signal=[signa],
sil=[si],
sils=[sis],
single=[singe],
singles=[singes],
slang=[sang],
slangs=[sangs],
slavon=[savon],
solda=[soda],
soldas=[sodas],
solde=[sode],
soldee=[sodee],
soldees=[sodees],
soldes=[sodes],
solin=[soin],
solins=[soins],
solute=[soute],
solutes=[soutes],
sonnaillent=[sonnaient],
soul=[sou],
soule=[soue],
soules=[soues],
souls=[sous],
soulte=[soute],
soultes=[soutes],
soupirail=[soupirai],
souple=[soupe],
souples=[soupes],
sourciller=[sourcier],
splitta=[spitta],
splittai=[spittai],
splittaient=[spittaient],
splittais=[spittais],
splittait=[spittait],
splittames=[spittames],
splittant=[spittant],
splittas=[spittas],
splittasse=[spittasse],
splittassent=[spittassent],
splittasses=[spittasses],
splittassiez=[spittassiez],
splittassions=[spittassions],
splittat=[spittat],
splittates=[spittates],
splitte=[spitte],
splittee=[spittee],
splittees=[spittees],
splittent=[spittent],
splitter=[spitter],
splittera=[spittera],
splitterai=[spitterai],
splitteraient=[spitteraient],
splitterais=[spitterais],
splitterait=[spitterait],
splitteras=[spitteras],
splitterent=[spitterent],
splitterez=[spitterez],
splitteriez=[spitteriez],
splitterions=[spitterions],
splitterons=[spitterons],
splitteront=[spitteront],
splittes=[spittes],
splittez=[spittez],
splittiez=[spittiez],
splittions=[spittions],
splittons=[spittons],
stiple=[stipe],
stiples=[stipes],
structural=[structura],
structurel=[structure],
structurelle=[structuree],
structurelles=[structurees],
structurels=[structures],
sublimes=[subimes],
subventionnel=[subventionne],
subventionnelle=[subventionnee],
subventionnelles=[subventionnees],
subventionnels=[subventionnes],
suffixal=[suffixa],
superficiel=[superficie],
superficiels=[superficies],
surfilez=[surfiez],
surfilons=[surfions],
surfils=[surfis],
surgelons=[surgeons],
sutural=[sutura],
syncopal=[syncopa],
tablar=[tabar],
tablars=[tabars],
tablasse=[tabasse],
tablassent=[tabassent],
tablasses=[tabasses],
tablassiez=[tabassiez],
tablassions=[tabassions],
tables=[tabes],
taille=[taie],
tailles=[taies],
talc=[tac],
talcs=[tacs],
tallons=[taons],
talon=[taon],
talons=[taons],
talqua=[taqua],
talquai=[taquai],
talquaient=[taquaient],
talquais=[taquais],
talquait=[taquait],
talquames=[taquames],
talquant=[taquant],
talquas=[taquas],
talquasse=[taquasse],
talquassent=[taquassent],
talquasses=[taquasses],
talquassiez=[taquassiez],
talquassions=[taquassions],
talquat=[taquat],
talquates=[taquates],
talque=[taque],
talquee=[taquee],
talquees=[taquees],
talquent=[taquent],
talquer=[taquer],
talquera=[taquera],
talquerai=[taquerai],
talqueraient=[taqueraient],
talquerais=[taquerais],
talquerait=[taquerait],
talqueras=[taqueras],
talquerent=[taquerent],
talquerez=[taquerez],
talqueriez=[taqueriez],
talquerions=[taquerions],
talquerons=[taquerons],
talqueront=[taqueront],
talques=[taques],
talquez=[taquez],
talquiez=[taquiez],
talquions=[taquions],
talquons=[taquons],
talure=[taure],
talures=[taures],
tamils=[tamis],
tardillons=[tardions],
tatillons=[tations],
tel=[te],
tele=[tee],
teles=[tees],
tell=[te],
telle=[tee],
telles=[tees],
tells=[tes],
tels=[tes],
temple=[tempe],
temples=[tempes],
tenaillent=[tenaient],
terminal=[termina],
terril=[terri],
terrils=[terris],
testacelle=[testacee],
testacelles=[testacees],
tibial=[tibia],
tillent=[tient],
tiraillent=[tiraient],
tolus=[tous],
tombal=[tomba],
tombelle=[tombee],
tombelles=[tombees],
tortils=[tortis],
touillez=[touiez],
touillons=[touions],
toupille=[toupie],
toupilles=[toupies],
tourbillons=[tourbions],
tournaillent=[tournaient],
tournillez=[tourniez],
tournillons=[tournions],
toussaillent=[toussaient],
traille=[traie],
trailles=[traies],
trainaillent=[trainaient],
tramail=[tramai],
tramails=[tramais],
translitera=[transitera],
transliterai=[transiterai],
transliteraient=[transiteraient],
transliterais=[transiterais],
transliterait=[transiterait],
transliteras=[transiteras],
transliterent=[transiterent],
transliterez=[transiterez],
transliteriez=[transiteriez],
transliterions=[transiterions],
transliterons=[transiterons],
tressaillent=[tressaient],
trial=[tria],
trials=[trias],
trilla=[tria],
trillai=[triai],
trillaient=[triaient],
trillais=[triais],
trillait=[triait],
trillames=[triames],
trillant=[triant],
trillas=[trias],
trillasse=[triasse],
trillassent=[triassent],
trillasses=[triasses],
trillassiez=[triassiez],
trillassions=[triassions],
trillat=[triat],
trillates=[triates],
trille=[trie],
trillent=[trient],
triller=[trier],
trillera=[triera],
trillerai=[trierai],
trilleraient=[trieraient],
trillerais=[trierais],
trillerait=[trierait],
trilleras=[trieras],
trillerent=[trierent],
trillerez=[trierez],
trilleriez=[trieriez],
trillerions=[trierions],
trillerons=[trierons],
trilleront=[trieront],
trilles=[tries],
trillez=[triez],
trilliez=[triiez],
trillions=[triions],
trillons=[trions],
triol=[trio],
triols=[trios],
triomphal=[triompha],
triple=[tripe],
triples=[tripes],
triplette=[tripette],
triplettes=[tripettes],
trochlee=[trochee],
trochlees=[trochees],
trompillons=[trompions],
tuilez=[tuiez],
tuilons=[tuions],
tulle=[tue],
tullerie=[tuerie],
tulleries=[tueries],
tulles=[tues],
turbinelle=[turbinee],
turbinelles=[turbinees],
urinal=[urina],
vaccinal=[vaccina],
vaccinelle=[vaccinee],
vaccinelles=[vaccinees],
val=[va],
valine=[vaine],
valines=[vaines],
vals=[vas],
valse=[vase],
valses=[vases],
valseuse=[vaseuse],
valseuses=[vaseuses],
valut=[vaut],
vannelle=[vannee],
vannelles=[vannees],
vantail=[vantai],
vegetal=[vegeta],
velte=[vete],
veltes=[vetes],
vetillez=[vetiez],
vetillons=[vetions],
videlle=[videe],
videlles=[videes],
vigile=[vigie],
vigiles=[vigies],
vile=[vie],
viles=[vies],
villa=[via],
ville=[vie],
villes=[vies],
vils=[vis],
viral=[vira],
vitale=[vitae],
vitrail=[vitrai],
vlan=[van],
voile=[voie],
voilent=[voient],
voiles=[voies],
volis=[vois],
vols=[vos],
volta=[vota],
voltai=[votai],
voltaient=[votaient],
voltais=[votais],
voltait=[votait],
voltames=[votames],
voltant=[votant],
voltas=[votas],
voltasse=[votasse],
voltassent=[votassent],
voltasses=[votasses],
voltassiez=[votassiez],
voltassions=[votassions],
voltat=[votat],
voltates=[votates],
volte=[vote],
voltent=[votent],
volter=[voter],
voltera=[votera],
volterai=[voterai],
volteraient=[voteraient],
volterais=[voterais],
volterait=[voterait],
volteras=[voteras],
volterent=[voterent],
volterez=[voterez],
volteriez=[voteriez],
volterions=[voterions],
volterons=[voterons],
volteront=[voteront],
voltes=[votes],
voltez=[votez],
voltiez=[votiez],
voltions=[votions],
voltons=[votons],
volute=[voute],
volutes=[voutes],
voulaient=[vouaient],
voulais=[vouais],
voulait=[vouait],
voulant=[vouant],
voulez=[vouez],
vouliez=[vouiez],
voulions=[vouions],
voulons=[vouons],
zele=[zee],
zeles=[zees],
zonal=[zona]
